"m49code","country_name","Year","total_pop","total_male_pop","total_female_pop","total_mig","total_male_mig","total_female_mig"
28,"Antigua and Barbuda",1990,66696,32251,34447,12029,5775,6254
28,"Antigua and Barbuda",1995,73619,35778,37834,17550,8046,9504
28,"Antigua and Barbuda",2000,83584,39390,44196,23071,10316,12755
28,"Antigua and Barbuda",2005,89253,42783,46473,24741,11052,13689
28,"Antigua and Barbuda",2010,94661,45367,49287,26412,11788,14624
28,"Antigua and Barbuda",2015,99923,47940,51986,28083,12524,15559
28,"Antigua and Barbuda",2017,102012,48966,53045,28646,12783,15863
12,"Algeria",1990,25912367,13117245,12795124,273954,150234,123720
12,"Algeria",1995,28904298,14639457,14264840,262032,143696,118336
12,"Algeria",2000,31183660,15803151,15380506,250110,137158,112952
12,"Algeria",2005,33288437,16835565,16452871,197422,108266,89156
12,"Algeria",2010,36117637,18230400,17887241,216964,114727,102237
12,"Algeria",2015,39871528,20133472,19738059,239473,126522,112951
12,"Algeria",2017,41318142,20866391,20451757,248624,131192,117432
31,"Azerbaijan",1990,7242770,3541448,3701320,360600,157856,202744
31,"Azerbaijan",1995,7775426,3797331,3978089,344070,149509,194561
31,"Azerbaijan",2000,8122741,3971455,4151288,327540,141161,186379
31,"Azerbaijan",2005,8538606,4206809,4331801,302220,135336,166884
31,"Azerbaijan",2010,9032457,4475090,4557375,276901,129512,147389
31,"Azerbaijan",2015,9617484,4786005,4831489,264241,126600,137641
31,"Azerbaijan",2017,9827589,4895306,4932284,259241,124205,135036
8,"Albania",1990,3281454,1680637,1600815,66013,30579,35434
8,"Albania",1995,3106736,1529234,1577485,71354,33284,38070
8,"Albania",2000,3121970,1577626,1544339,76695,35990,40705
8,"Albania",2005,3079179,1544008,1535172,64739,32993,31746
8,"Albania",2010,2940525,1475395,1465122,52784,26901,25883
8,"Albania",2015,2923352,1475867,1447487,52031,26517,25514
8,"Albania",2017,2930187,1479140,1451035,52484,26721,25763
51,"Armenia",1990,3538165,1714811,1823346,658789,270535,388254
51,"Armenia",1995,3217342,1524014,1693330,693999,284995,409004
51,"Armenia",2000,3069588,1440919,1628672,657900,270170,387730
51,"Armenia",2005,2981259,1401868,1579384,469119,191401,277718
51,"Armenia",2010,2877311,1346350,1530958,221560,90345,131215
51,"Armenia",2015,2916950,1370760,1546195,191199,77436,113763
51,"Armenia",2017,2930450,1378337,1552102,190719,77221,113498
24,"Angola",1990,12171441,5951051,6220386,33517,18142,15375
24,"Angola",1995,14268994,6972030,7296960,39813,20755,19058
24,"Angola",2000,16440924,8033544,8407377,46108,23367,22741
24,"Angola",2005,19552542,9556744,9995794,61329,30240,31089
24,"Angola",2010,23369131,11433112,11936012,76549,37113,39436
24,"Angola",2015,27859305,13653563,14205740,632178,304635,327543
24,"Angola",2017,29784193,14605260,15178925,638499,307681,330818
16,"American Samoa",1990,47038,NA,NA,21283,11175,10108
16,"American Samoa",1995,52868,NA,NA,23098,12037,11061
16,"American Samoa",2000,57521,NA,NA,24912,12898,12014
16,"American Samoa",2005,59118,NA,NA,24233,12498,11735
16,"American Samoa",2010,55637,NA,NA,23555,12098,11457
16,"American Samoa",2015,55537,NA,NA,23513,11998,11515
16,"American Samoa",2017,55641,NA,NA,23561,12023,11538
32,"Argentina",1990,32729739,16047205,16682536,1649919,788130,861789
32,"Argentina",1995,34994814,17142955,17851863,1595069,753027,842042
32,"Argentina",2000,37057452,18131323,18926128,1540219,717924,822295
32,"Argentina",2005,39145488,19148910,19996583,1673088,774810,898278
32,"Argentina",2010,41223889,20163796,21060099,1805957,831696,974261
32,"Argentina",2015,43417765,21245214,22172550,2086302,960310,1125992
32,"Argentina",2017,44271041,21667864,22603172,2164524,996316,1168208
36,"Australia",1990,17041431,8497671,8543759,3955213,2013196,1942017
36,"Australia",1995,18076743,8994674,9082071,4153330,2093280,2060050
36,"Australia",2000,19065837,9511525,9554318,4386250,2189900,2196350
36,"Australia",2005,20238903,10100763,10138138,4878030,2419190,2458840
36,"Australia",2010,22120064,11061412,11058649,5882980,2922030,2960950
36,"Australia",2015,23799556,11861620,11937926,6710540,3296230,3414310
36,"Australia",2017,24450561,12180591,12269968,7035560,3441530,3594030
48,"Bahrain",1990,495931,286169,209760,173212,122730,50482
48,"Bahrain",1995,563699,324897,238802,205979,144227,61752
48,"Bahrain",2000,664614,381224,283386,239361,165344,74017
48,"Bahrain",2005,889168,534143,355018,404018,288614,115404
48,"Bahrain",2010,1240862,774053,466813,657856,475905,181951
48,"Bahrain",2015,1371855,846759,525099,704137,508966,195171
48,"Bahrain",2017,1492584,936281,556298,722649,522347,200302
52,"Barbados",1990,260374,125317,135052,24024,10065,13959
52,"Barbados",1995,264959,127494,137469,26224,11235,14989
52,"Barbados",2000,269847,129632,140204,28424,12405,16019
52,"Barbados",2005,274009,131533,142479,30624,13575,17049
52,"Barbados",2010,279569,134147,145421,32825,14746,18079
52,"Barbados",2015,284217,136173,148035,34475,15488,18987
52,"Barbados",2017,285719,136794,148925,34660,15572,19088
60,"Bermuda",1990,60930,NA,NA,15683,7557,8126
60,"Bermuda",1995,62696,NA,NA,16676,8044,8632
60,"Bermuda",2000,64028,NA,NA,17668,8531,9137
60,"Bermuda",2005,65130,NA,NA,18276,8866,9410
60,"Bermuda",2010,63956,NA,NA,18884,9202,9682
60,"Bermuda",2015,62003,NA,NA,19126,9336,9790
60,"Bermuda",2017,61349,NA,NA,18954,9253,9701
44,"Bahamas",1990,256336,127162,129173,26855,13827,13028
44,"Bahamas",1995,280150,138411,141749,31654,16620,15034
44,"Bahamas",2000,297890,145096,152791,36454,19414,17040
44,"Bahamas",2005,329249,160706,168529,45595,23646,21949
44,"Bahamas",2010,360832,176387,184441,54736,27878,26858
44,"Bahamas",2015,386838,189349,197489,59306,29994,29312
44,"Bahamas",2017,395361,193585,201773,61806,31259,30547
50,"Bangladesh",1990,106188642,54270963,51917683,881617,476097,405520
50,"Bangladesh",1995,118706871,60607851,58099021,934735,503989,430746
50,"Bangladesh",2000,131581243,67144696,64436552,987853,531907,455946
50,"Bangladesh",2005,143431101,73051458,70379648,1166700,621228,545472
50,"Bangladesh",2010,152149102,76941073,75208038,1345546,710548,634998
50,"Bangladesh",2015,161200886,81342973,79857915,1422805,752035,670770
50,"Bangladesh",2017,164669751,83035767,81633974,1500921,791164,709757
84,"Belize",1990,187552,94572,92982,30404,16393,14011
84,"Belize",1995,206963,104241,102721,33446,17512,15934
84,"Belize",2000,247315,124516,122794,36488,18631,17857
84,"Belize",2005,283277,142333,140951,41424,21045,20379
84,"Belize",2010,321608,160868,160738,46360,23459,22901
84,"Belize",2015,359288,179106,180181,54674,27502,27172
84,"Belize",2017,374681,186549,188137,59998,30180,29818
70,"Bosnia and Herzegovina",1990,4463422,2210490,2252932,56000,26538,29462
70,"Bosnia and Herzegovina",1995,3843712,1885952,1957761,69476,33115,36361
70,"Bosnia and Herzegovina",2000,3766706,1849595,1917112,82952,39691,43261
70,"Bosnia and Herzegovina",2005,3781530,1857791,1923737,47272,22473,24799
70,"Bosnia and Herzegovina",2010,3722084,1828007,1894073,38792,18504,20288
70,"Bosnia and Herzegovina",2015,3535961,1735497,1800458,38574,18400,20174
70,"Bosnia and Herzegovina",2017,3507017,1721709,1785306,37100,17697,19403
68,"Bolivia",1990,6856244,3437040,3419203,73758,37549,36209
68,"Bolivia",1995,7566714,3794028,3772687,83598,42806,40792
68,"Bolivia",2000,8339512,4181464,4158056,92658,47665,44993
68,"Bolivia",2005,9125409,4574929,4550477,107745,56019,51726
68,"Bolivia",2010,9918242,4970472,4947772,122846,64380,58466
68,"Bolivia",2015,10724705,5370710,5353993,142989,74939,68050
68,"Bolivia",2017,11051600,5532690,5518902,148837,78004,70833
104,"Burma",1990,40626250,19881828,20744424,133545,72310,61235
104,"Burma",1995,43237792,21177834,22059949,113663,61489,52174
104,"Burma",2000,46095462,22519793,23575666,98011,52150,45861
104,"Burma",2005,48482614,23681861,24800750,83025,44506,38519
104,"Burma",2010,50155896,24477977,25677919,76414,41574,34840
104,"Burma",2015,52403669,25593153,26810525,73308,40177,33131
104,"Burma",2017,53370609,26067524,27303083,74660,40918,33742
204,"Benin",1990,4978496,2423540,2554949,76212,40092,36120
204,"Benin",1995,5905558,2894758,3010794,104971,55858,49113
204,"Benin",2000,6865951,3382858,3483088,133730,71624,62106
204,"Benin",2005,7982225,3955402,4026821,171499,93882,77617
204,"Benin",2010,9199259,4568834,4630420,209267,116139,93128
204,"Benin",2015,10575952,5270132,5305830,245399,137662,107737
204,"Benin",2017,11175692,5574556,5601137,253284,142168,111116
90,"Solomon Islands",1990,311840,160211,151626,4226,2349,1877
90,"Solomon Islands",1995,359225,184504,174728,4178,2328,1850
90,"Solomon Islands",2000,412609,212085,200523,3981,2224,1757
90,"Solomon Islands",2005,469885,240062,229826,3271,1830,1441
90,"Solomon Islands",2010,527790,268171,259625,2760,1546,1214
90,"Solomon Islands",2015,587482,298624,288852,2585,1450,1135
90,"Solomon Islands",2017,611343,310795,300549,2532,1421,1111
76,"Brazil",1990,149352145,74065784,75286360,798517,426147,372370
76,"Brazil",1995,162296612,80326479,81970128,741557,396152,345405
76,"Brazil",2000,175287587,86623241,88664347,684596,366156,318440
76,"Brazil",2005,186917361,92224756,94692614,638582,343019,295563
76,"Brazil",2010,196796269,96931916,99864355,592568,319882,272686
76,"Brazil",2015,205962108,101283709,104678403,716568,386838,329730
76,"Brazil",2017,209288278,102855016,106433262,735557,397090,338467
100,"Bulgaria",1990,8841371,4357401,4483965,21510,9047,12463
100,"Bulgaria",1995,8379180,4101951,4277227,32435,13642,18793
100,"Bulgaria",2000,7997787,3897665,4100113,43360,18238,25122
100,"Bulgaria",2005,7683763,3739041,3944721,61074,26594,34480
100,"Bulgaria",2010,7404590,3605148,3799445,76287,33841,42446
100,"Bulgaria",2015,7177396,3490100,3687292,133803,59356,74447
100,"Bulgaria",2017,7084571,3443898,3640679,153803,68229,85574
96,"Brunei Darussalam",1990,258785,136464,122315,73200,41856,31344
96,"Brunei Darussalam",1995,297192,155369,141825,84748,47832,36916
96,"Brunei Darussalam",2000,333241,168754,164492,96296,53807,42489
96,"Brunei Darussalam",2005,365158,186402,178762,98441,55265,43176
96,"Brunei Darussalam",2010,388662,200662,187995,100587,56723,43864
96,"Brunei Darussalam",2015,417542,215100,202446,102733,58181,44552
96,"Brunei Darussalam",2017,428697,220638,208068,108612,61511,47101
124,"Canada",1990,27692680,13732473,13960204,4333318,2109652,2223666
124,"Canada",1995,29330073,14520496,14809576,4864778,2356105,2508673
124,"Canada",2000,30735773,15225062,15510713,5511914,2659135,2852779
124,"Canada",2005,32287980,16006416,16281563,6078985,2915838,3163147
124,"Canada",2010,34168668,16952293,17216375,6761226,3236539,3524687
124,"Canada",2015,35949709,17832283,18117423,7561226,3619492,3941734
124,"Canada",2017,36624199,18172129,18452071,7861226,3763100,4098126
116,"Cambodia",1990,8973342,4333591,4639749,38375,19084,19291
116,"Cambodia",1995,10653558,5172106,5481453,92230,45361,46869
116,"Cambodia",2000,12152354,5906074,6246284,146085,71638,74447
116,"Cambodia",2005,13270201,6440468,6829733,114031,57511,56520
116,"Cambodia",2010,14308740,6970352,7338384,81977,43385,38592
116,"Cambodia",2015,15517635,7568575,7949051,73963,39854,34109
116,"Cambodia",2017,16005373,7809580,8195793,76329,41129,35200
144,"Sri Lanka",1990,17329713,8750016,8579702,41561,23423,18138
144,"Sri Lanka",1995,18247121,9165026,9082101,40841,22689,18152
144,"Sri Lanka",2000,18781938,9368070,9413880,40132,21971,18161
144,"Sri Lanka",2005,19524558,9625259,9899300,39526,21318,18208
144,"Sri Lanka",2010,20198353,9828887,10369473,38959,20694,18265
144,"Sri Lanka",2015,20714040,9978842,10735198,39706,20745,18961
144,"Sri Lanka",2017,20876917,10033751,10843148,40018,20909,19109
178,"Congo",1990,2440457,1217095,1223356,129597,64418,65179
178,"Congo",1995,2799255,1396359,1402901,191635,95822,95813
178,"Congo",2000,3225727,1610582,1615153,305002,152666,152336
178,"Congo",2005,3718243,1858182,1860063,315238,171420,143818
178,"Congo",2010,4386693,2193991,2192709,419649,228180,191469
178,"Congo",2015,4995648,2498945,2496699,392996,215274,177722
178,"Congo",2017,5260750,2631570,2629173,398890,218503,180387
180,"Democratic Republic of the Congo",1990,34614581,17080405,17534179,754194,363117,391077
180,"Democratic Republic of the Congo",1995,41595744,20583366,21012372,1816963,901379,915584
180,"Democratic Republic of the Congo",2000,47076387,23344549,23731841,744387,365092,379295
180,"Democratic Republic of the Congo",2005,54751476,27204717,27546763,622869,302290,320579
180,"Democratic Republic of the Congo",2010,64523263,32121415,32401848,588950,284244,304706
180,"Democratic Republic of the Congo",2015,76196619,37996074,38200541,824492,401058,423434
180,"Democratic Republic of the Congo",2017,81339988,40581486,40758512,879223,427877,451346
108,"Burundi",1990,5415415,2643523,2771897,333110,163267,169843
108,"Burundi",1995,5962058,2900888,3061168,254853,124165,130688
108,"Burundi",2000,6400706,3140702,3260004,125628,61094,64534
108,"Burundi",2005,7423289,3650627,3772654,172874,84805,88069
108,"Burundi",2010,8766930,4304969,4461967,235259,115823,119436
108,"Burundi",2015,10199270,5015272,5183995,289810,142790,147020
108,"Burundi",2017,10864245,5346538,5517704,299569,147599,151970
156,"China",1990,1192756898,612089764,580667136,376361,191954,184407
156,"China",1995,1261168516,647498772,613669748,442198,223018,219180
156,"China",2000,1305039205,670141871,634897342,508034,254082,253952
156,"China",2005,1344226376,691024890,653201480,678947,379920,299027
156,"China",2010,1382857508,711513642,671343872,849861,505758,344103
156,"China",2015,1420514308,731506788,689007515,978046,600136,377910
156,"China",2017,1433143853,738110606,695033248,999527,613317,386210
4,"Afghanistan",1990,12249114,6267968,5981147,57686,32558,25128
4,"Afghanistan",1995,17099541,8849356,8250185,71522,39105,32417
4,"Afghanistan",2000,20093756,10346992,9746775,75917,42848,33069
4,"Afghanistan",2005,25070798,12969246,12101550,87300,49274,38026
4,"Afghanistan",2010,28803167,14797692,14005472,102246,57709,44537
4,"Afghanistan",2015,33736494,17389625,16346869,489749,248212,241537
4,"Afghanistan",2017,35530081,18309892,17220191,133612,66738,66874
64,"Bhutan",1990,537280,276086,261198,23807,19409,4398
64,"Bhutan",1995,514877,263227,251659,27972,22804,5168
64,"Bhutan",2000,573416,292710,280699,32137,26200,5937
64,"Bhutan",2005,656639,344888,311752,40279,32742,7537
64,"Bhutan",2010,727641,385614,342031,48420,39283,9137
64,"Bhutan",2015,787386,418443,368944,51106,41441,9665
64,"Bhutan",2017,807610,428631,378982,52296,42406,9890
152,"Chile",1990,13242132,6532459,6709677,107501,54547,52954
152,"Chile",1995,14296613,7062089,7234523,142417,69632,72785
152,"Chile",2000,15262754,7546045,7716710,177332,84717,92615
152,"Chile",2005,16147064,7987254,8159812,273384,129398,143986
152,"Chile",2010,16993354,8410312,8583039,369436,174079,195357
152,"Chile",2015,17762681,8796512,8966171,469436,221200,248236
152,"Chile",2017,18054726,8943756,9110966,488571,230217,258354
136,"Cayman Islands",1990,25010,NA,NA,9387,4622,4765
136,"Cayman Islands",1995,31672,NA,NA,14320,7166,7154
136,"Cayman Islands",2000,41687,NA,NA,19253,9709,9544
136,"Cayman Islands",2005,48622,NA,NA,21655,11011,10644
136,"Cayman Islands",2010,55507,NA,NA,24057,12312,11745
136,"Cayman Islands",2015,59963,NA,NA,23726,12143,11583
136,"Cayman Islands",2017,61559,NA,NA,24355,12465,11890
120,"Cameroon",1990,11715218,5818117,5897102,265344,145527,119817
120,"Cameroon",1995,13460994,6696371,6764619,246864,135079,111785
120,"Cameroon",2000,15274234,7613610,7660626,228383,124630,103753
120,"Cameroon",2005,17420795,8698514,8722279,258737,142397,116340
120,"Cameroon",2010,19970495,9985480,9985022,289091,160164,128927
120,"Cameroon",2015,22834522,11424075,11410454,508357,251316,257041
120,"Cameroon",2017,24053727,12038252,12015484,540266,266653,273613
148,"Chad",1990,5956859,2957188,2999672,74342,40133,34209
148,"Chad",1995,7000722,3481688,3519033,89584,48298,41286
148,"Chad",2000,8342559,4155472,4187082,104825,56463,48362
148,"Chad",2005,10067009,5025054,5041948,352062,159715,192347
148,"Chad",2010,11887202,5945019,5942189,416924,186773,230151
148,"Chad",2015,14009413,7011174,6998240,516968,238140,278828
148,"Chad",2017,14899994,7458383,7441619,489690,225575,264115
174,"Comoros",1990,411594,206386,205212,14079,6717,7362
174,"Comoros",1995,475394,238801,236593,13939,6614,7325
174,"Comoros",2000,542357,272853,269505,13799,6511,7288
174,"Comoros",2005,611627,308012,303613,13209,6286,6923
174,"Comoros",2010,689692,347627,342069,12618,6060,6558
174,"Comoros",2015,777424,392089,385346,12555,6071,6484
174,"Comoros",2017,813912,410533,403378,12555,6071,6484
170,"Colombia",1990,34271565,17020763,17250803,104277,53109,51168
170,"Colombia",1995,37441977,18547489,18894482,106943,54666,52277
170,"Colombia",2000,40403958,19980925,20423033,109609,56223,53386
170,"Colombia",2005,43285634,21375978,21909657,107612,55706,51906
170,"Colombia",2010,45918097,22640901,23277207,124271,65622,58649
170,"Colombia",2015,48228697,23743535,24485169,139134,74108,65026
170,"Colombia",2017,49065615,24140122,24925490,142319,75805,66514
188,"Costa Rica",1990,3095995,1560468,1535523,417628,212173,205455
188,"Costa Rica",1995,3510926,1765944,1744983,364287,184485,179802
188,"Costa Rica",2000,3925443,1970393,1955051,310946,156798,154148
188,"Costa Rica",2005,4247841,2129856,2117986,358175,176335,181840
188,"Costa Rica",2010,4545280,2276833,2268445,405404,195873,209531
188,"Costa Rica",2015,4807852,2405543,2402300,411697,197613,214084
188,"Costa Rica",2017,4905769,2453561,2452204,414214,198822,215392
140,"Central African Republic",1990,2939780,1443775,1496004,67234,35686,31548
140,"Central African Republic",1995,3352767,1647590,1705169,99712,52975,46737
140,"Central African Republic",2000,3754986,1847763,1907222,123529,65636,57893
140,"Central African Republic",2005,4127910,2034901,2093008,94449,50236,44213
140,"Central African Republic",2010,4448525,2194630,2253891,93466,49743,43723
140,"Central African Republic",2015,4546100,2242275,2303828,81598,43163,38435
140,"Central African Republic",2017,4659080,2298022,2361064,88774,47030,41744
192,"Cuba",1990,10582081,5331571,5250512,34555,17278,17277
192,"Cuba",1995,10906043,5489894,5416150,26187,12559,13628
192,"Cuba",2000,11150736,5594314,5556416,17818,7840,9978
192,"Cuba",2005,11284253,5660732,5623520,17023,7540,9483
192,"Cuba",2010,11333051,5677985,5655069,14818,6611,8207
192,"Cuba",2015,11461432,5735179,5726255,13336,5950,7386
192,"Cuba",2017,11484636,5744766,5739871,13136,5861,7275
132,"Cape Verde",1990,341883,162249,179640,8931,4429,4502
132,"Cape Verde",1995,389127,187042,202082,9979,5091,4888
132,"Cape Verde",2000,435079,209880,225203,11027,5753,5274
132,"Cape Verde",2005,474567,232139,242427,12700,6523,6177
132,"Cape Verde",2010,502384,249595,252786,14373,7293,7080
132,"Cape Verde",2015,532913,265363,267545,14924,7547,7377
132,"Cape Verde",2017,546388,272265,274121,15295,7735,7560
184,"Cook Islands",1990,18356,NA,NA,2587,1443,1144
184,"Cook Islands",1995,18956,NA,NA,2686,1497,1189
184,"Cook Islands",2000,18122,NA,NA,2785,1552,1233
184,"Cook Islands",2005,19710,NA,NA,3277,1724,1553
184,"Cook Islands",2010,18545,NA,NA,3769,1895,1874
184,"Cook Islands",2015,17449,NA,NA,4152,2078,2074
184,"Cook Islands",2017,17380,NA,NA,4213,2109,2104
196,"Cyprus",1990,766614,388628,377989,43805,20463,23342
196,"Cyprus",1995,855384,431792,423601,61941,27604,34337
196,"Cyprus",2000,943286,475425,467863,80076,34745,45331
196,"Cyprus",2005,1027658,520472,507185,117165,50421,66744
196,"Cyprus",2010,1112607,555578,557033,188472,82477,105995
196,"Cyprus",2015,1160985,581395,579588,192020,84153,107867
196,"Cyprus",2017,1179551,590479,589067,188973,82769,106204
208,"Denmark",1990,5141115,2535813,2605304,235189,114411,120778
208,"Denmark",1995,5232704,2585062,2647647,303108,147194,155914
208,"Denmark",2000,5341194,2642895,2698297,371026,179977,191049
208,"Denmark",2005,5421702,2685327,2736374,440383,213097,227286
208,"Denmark",2010,5554844,2756283,2798566,509740,246217,263523
208,"Denmark",2015,5688695,2828808,2859887,595876,291431,304445
208,"Denmark",2017,5733551,2851730,2881821,656789,324239,332550
262,"Djibouti",1990,590398,296959,293434,122221,64242,57979
262,"Djibouti",1995,630388,317169,313216,99774,52476,47298
262,"Djibouti",2000,717584,360759,356818,100507,52920,47587
262,"Djibouti",2005,783254,393626,389622,92091,51315,40776
262,"Djibouti",2010,851146,427561,423588,101575,53295,48280
262,"Djibouti",2015,927414,465561,461853,112351,59081,53270
262,"Djibouti",2017,956985,480254,476740,116089,61025,55064
212,"Dominica",1990,70926,NA,NA,2519,1309,1210
212,"Dominica",1995,71368,NA,NA,3121,1623,1498
212,"Dominica",2000,69676,NA,NA,3723,1955,1768
212,"Dominica",2005,70627,NA,NA,4744,2491,2253
212,"Dominica",2010,71440,NA,NA,5765,3027,2738
212,"Dominica",2015,73162,NA,NA,6720,3528,3192
212,"Dominica",2017,73925,NA,NA,6782,3561,3221
214,"Dominican Republic",1990,7183647,3614408,3569238,291151,181677,109474
214,"Dominican Republic",1995,7892423,3963648,3928780,323381,198842,124539
214,"Dominican Republic",2000,8562622,4291265,4271359,355611,216008,139603
214,"Dominican Republic",2005,9237566,4619835,4617725,376001,228180,147821
214,"Dominican Republic",2010,9897985,4940721,4957255,393720,238742,154978
214,"Dominican Republic",2015,10528394,5246102,5282297,415564,251890,163674
214,"Dominican Republic",2017,10766998,5361338,5405663,424964,257588,167376
218,"Ecuador",1990,10218091,5134165,5083920,78663,38531,40132
218,"Ecuador",1995,11440583,5743434,5697146,115093,57879,57214
218,"Ecuador",2000,12628596,6331205,6297391,151523,77227,74296
218,"Ecuador",2005,13735233,6878670,6856562,187404,96188,91216
218,"Ecuador",2010,14934690,7472290,7462396,325366,167773,157593
218,"Ecuador",2015,16144368,8071060,8073297,387513,200352,187161
218,"Ecuador",2017,16624858,8308819,8316035,399068,206327,192741
818,"Egypt",1990,57412215,28822441,28589773,173708,91928,81780
818,"Egypt",1995,63714386,32058504,31655874,166955,88545,78410
818,"Egypt",2000,69905988,35164257,34741727,173452,92205,81247
818,"Egypt",2005,76778149,38706637,38071514,274001,158277,115724
818,"Egypt",2010,84107606,42465970,41641633,295714,166071,129643
818,"Egypt",2015,93778172,47408942,46369234,565931,317824,248107
818,"Egypt",2017,97553151,49324991,48228158,478310,257661,220649
372,"Ireland",1990,3569257,1777059,1792202,227961,112093,115868
372,"Ireland",1995,3651545,1814239,1837310,226892,108084,118808
372,"Ireland",2000,3848776,1914257,1934529,350552,172959,177593
372,"Ireland",2005,4212977,2104335,2108641,589046,309910,279136
372,"Ireland",2010,4626928,2305264,2321664,730542,360440,370102
372,"Ireland",2015,4700107,2331124,2368984,749943,359898,390045
372,"Ireland",2017,4761657,2361567,2400085,806549,394255,412294
226,"Equatorial Guinea",1990,426846,211535,215318,2740,1465,1275
226,"Equatorial Guinea",1995,504871,255198,249682,3629,1930,1699
226,"Equatorial Guinea",2000,614323,318062,296261,4517,2394,2123
226,"Equatorial Guinea",2005,757317,401184,356143,6588,3564,3024
226,"Equatorial Guinea",2010,951104,516479,434623,8658,4734,3924
226,"Equatorial Guinea",2015,1175389,648404,526976,209611,161527,48084
226,"Equatorial Guinea",2017,1267689,701757,565935,221865,170970,50895
233,"Estonia",1990,1565242,731960,833283,381997,171691,210306
233,"Estonia",1995,1433024,663234,769792,315755,136268,179487
233,"Estonia",2000,1399112,652559,746552,249512,100844,148668
233,"Estonia",2005,1355648,629986,725664,233701,94244,139457
233,"Estonia",2010,1332102,620356,711747,217890,87644,130246
233,"Estonia",2015,1315321,615189,700141,194664,80024,114640
233,"Estonia",2017,1309632,613621,696009,192962,80654,112308
232,"Eritrea",1990,3113311,1556853,1556459,11848,6228,5620
232,"Eritrea",1995,3090159,1544364,1545799,12400,6542,5858
232,"Eritrea",2000,3392801,1696287,1696519,12952,6856,6096
232,"Eritrea",2005,3969007,1985025,1983985,14314,7729,6585
232,"Eritrea",2010,4390840,2197503,2193336,15676,8603,7073
232,"Eritrea",2015,4846976,2427799,2419187,15941,8833,7108
232,"Eritrea",2017,5068831,2539813,2529011,16041,8889,7152
222,"El Salvador",1990,5254984,2564896,2690090,47360,22218,25142
222,"El Salvador",1995,5611115,2724643,2886476,39537,18564,20973
222,"El Salvador",2000,5867626,2827449,3040182,31713,14909,16804
222,"El Salvador",2005,6028961,2878346,3150607,36019,17029,18990
222,"El Salvador",2010,6164626,2918538,3246088,40324,19148,21176
222,"El Salvador",2015,6312478,2969971,3342508,42045,19996,22049
222,"El Salvador",2017,6377853,2995112,3382731,42323,20129,22194
231,"Ethiopia",1990,48086516,23981106,24105413,1155390,607284,548106
231,"Ethiopia",1995,57309880,28573061,28736825,806904,424117,382787
231,"Ethiopia",2000,66537331,33176663,33360677,611384,322219,289165
231,"Ethiopia",2005,76727083,38276287,38450795,514242,269725,244517
231,"Ethiopia",2010,87702670,43768157,43934519,567720,297534,270186
231,"Ethiopia",2015,99873033,49860882,50012145,1162576,591876,570700
231,"Ethiopia",2017,104957438,52406024,52551410,1227143,624222,602921
40,"Austria",1990,7723949,3694671,4029283,793239,368287,424952
40,"Austria",1995,7990121,3856496,4133617,894893,423302,471591
40,"Austria",2000,8069276,3916404,4152872,996547,478318,518229
40,"Austria",2005,8253650,4012059,4241597,1136270,543618,592652
40,"Austria",2010,8409949,4098642,4311303,1275992,608918,667074
40,"Austria",2015,8678657,4248652,4430011,1492374,716470,775904
40,"Austria",2017,8735453,4283095,4452364,1660283,797082,863201
203,"Czech Republic",1990,10341169,5019963,5321207,110394,57405,52989
203,"Czech Republic",1995,10358456,5033465,5324994,165592,88316,77276
203,"Czech Republic",2000,10289594,5005561,5284026,220789,119227,101562
203,"Czech Republic",2005,10258176,4996535,5261645,322540,181719,140821
203,"Czech Republic",2010,10536286,5171406,5364879,398493,236160,162333
203,"Czech Republic",2015,10603762,5210402,5393362,416454,239228,177226
203,"Czech Republic",2017,10618303,5219396,5398907,433290,248560,184730
254,"French Guiana",1990,115784,60326,55458,63612,34843,28769
254,"French Guiana",1995,137400,71212,66188,70131,36869,33262
254,"French Guiana",2000,163165,84222,78941,76649,38895,37754
254,"French Guiana",2005,203826,100964,102865,86468,42729,43739
254,"French Guiana",2010,234181,117030,117138,96288,46564,49724
254,"French Guiana",2015,268691,134315,134375,106108,50399,55709
254,"French Guiana",2017,282731,141340,141398,111718,53064,58654
246,"Finland",1990,4996222,2424637,2571583,63255,31682,31573
246,"Finland",1995,5119005,2492626,2626386,99729,49575,50154
246,"Finland",2000,5187954,2532578,2655375,136203,67469,68734
246,"Finland",2005,5258927,2574006,2684927,192169,96429,95740
246,"Finland",2010,5365782,2633331,2732453,248135,125389,122746
246,"Finland",2015,5481966,2697840,2784128,314856,159315,155541
246,"Finland",2017,5523231,2721767,2801470,343582,174807,168775
242,"Fiji",1990,728628,370082,358545,13283,6847,6436
242,"Fiji",1995,775498,394115,381375,13001,6726,6275
242,"Fiji",2000,811223,412022,399206,12719,6601,6118
242,"Fiji",2005,821817,419049,402775,12435,6564,5871
242,"Fiji",2010,859950,438922,421032,13351,7137,6214
242,"Fiji",2015,892149,453628,438516,13751,7421,6330
242,"Fiji",2017,905502,459668,445833,13911,7508,6403
238,"Falkland Islands (Malvinas)",1990,1989,NA,NA,855,488,367
238,"Falkland Islands (Malvinas)",1995,2435,NA,NA,868,510,358
238,"Falkland Islands (Malvinas)",2000,2882,NA,NA,1067,636,431
238,"Falkland Islands (Malvinas)",2005,2939,NA,NA,1166,675,491
238,"Falkland Islands (Malvinas)",2010,2852,NA,NA,1436,807,629
238,"Falkland Islands (Malvinas)",2015,2898,NA,NA,1571,873,698
238,"Falkland Islands (Malvinas)",2017,2910,NA,NA,1579,878,701
583,"Micronesia, Federated States of",1990,96331,49273,47058,3685,2099,1586
583,"Micronesia, Federated States of",1995,107556,54984,52576,3342,2119,1223
583,"Micronesia, Federated States of",2000,107432,54379,53047,3116,1721,1395
583,"Micronesia, Federated States of",2005,106196,53967,52228,2905,1565,1340
583,"Micronesia, Federated States of",2010,103616,52901,50718,2805,1502,1303
583,"Micronesia, Federated States of",2015,104433,53481,50946,2756,1473,1283
583,"Micronesia, Federated States of",2017,105544,54093,51445,2785,1489,1296
258,"French Polynesia",1990,198375,103074,95291,25830,15444,10386
258,"French Polynesia",1995,215196,111781,103418,28360,16689,11671
258,"French Polynesia",2000,237258,122144,115117,30329,17604,12725
258,"French Polynesia",2005,254886,130727,124149,32286,18405,13881
258,"French Polynesia",2010,267820,136993,130823,31640,18037,13603
258,"French Polynesia",2015,277690,141575,136111,30058,17136,12922
258,"French Polynesia",2017,283007,144101,138896,30687,17495,13192
250,"France",1990,56960835,27969140,28991697,5897267,2999376,2897891
250,"France",1995,58241791,28542151,29699639,6087993,3046083,3041910
250,"France",2000,59608201,29223775,30384429,6278718,3092789,3185929
250,"France",2005,61233900,30040031,31193877,6737600,3300859,3436741
250,"France",2010,63026740,30933311,32093432,7196481,3508928,3687553
250,"France",2015,64457201,31672756,32784443,7918382,3826543,4091839
250,"France",2017,64979548,31948700,33030848,7902783,3808841,4093942
270,"Gambia",1990,916808,461577,455236,118123,66306,51817
270,"Gambia",1995,1066223,533431,532789,150890,82048,68842
270,"Gambia",2000,1231844,611944,619910,182514,97138,85376
270,"Gambia",2005,1444204,716125,728090,181905,96230,85675
270,"Gambia",2010,1692149,838031,854116,185763,98086,87677
270,"Gambia",2015,1977590,978959,998625,192540,101501,91039
270,"Gambia",2017,2100568,1039739,1060832,205063,108103,96960
266,"Gabon",1990,952212,466384,485830,127980,73053,54927
266,"Gabon",1995,1086137,534453,551683,152972,87305,65667
266,"Gabon",2000,1231122,610669,620443,195571,111616,83955
266,"Gabon",2005,1403126,702725,700401,214123,122279,91844
266,"Gabon",2010,1640210,836931,803282,243992,139458,104534
266,"Gabon",2015,1930175,991862,938316,268384,153144,115240
266,"Gabon",2017,2025137,1040223,984906,280197,159885,120312
268,"Georgia",1990,5410372,2572122,2838252,304470,133285,171185
268,"Georgia",1995,5020061,2384619,2635448,152235,66643,85592
268,"Georgia",2000,4722059,2238494,2483559,76117,33321,42796
268,"Georgia",2005,4486547,2119465,2367085,72311,31655,40656
268,"Georgia",2010,4231661,2010118,2221534,73034,31972,41062
268,"Georgia",2015,3951524,1885939,2065578,76685,33570,43115
268,"Georgia",2017,3912061,1867823,2044246,78218,34241,43977
288,"Ghana",1990,14628260,7433549,7194715,164851,83030,81821
288,"Ghana",1995,16760467,8473962,8286506,252879,127423,125456
288,"Ghana",2000,18938762,9564981,9373774,191601,97279,94322
288,"Ghana",2005,21542009,10763707,10778294,304436,159363,145073
288,"Ghana",2010,24512104,12133842,12378251,337017,171558,165459
288,"Ghana",2015,27582821,13723929,13858891,399471,203351,196120
288,"Ghana",2017,28833629,14367702,14465921,417642,212601,205041
308,"Grenada",1990,96283,47515,48775,4263,2106,2157
308,"Grenada",1995,100255,49584,50667,5544,2746,2798
308,"Grenada",2000,101619,50245,51377,6825,3386,3439
308,"Grenada",2005,102949,51178,51774,6902,3424,3478
308,"Grenada",2010,104677,52296,52380,6980,3463,3517
308,"Grenada",2015,106823,53584,53243,7057,3502,3555
308,"Grenada",2017,107825,54143,53673,7124,3536,3588
304,"Greenland",1990,55604,NA,NA,9416,6565,2851
304,"Greenland",1995,55811,NA,NA,7320,5011,2309
304,"Greenland",2000,56175,NA,NA,6755,4723,2032
304,"Greenland",2005,56951,NA,NA,6686,4549,2137
304,"Greenland",2010,56638,NA,NA,6226,4210,2016
304,"Greenland",2015,56377,NA,NA,6009,3951,2058
304,"Greenland",2017,56480,NA,NA,6014,3955,2059
276,"Germany",1990,79118326,38169232,40949097,5936181,3293128,2643053
276,"Germany",1995,81240604,39386786,41853823,7464406,3898397,3566009
276,"Germany",2000,81487757,39680441,41807312,8992631,4503666,4488965
276,"Germany",2005,81671234,39908226,41763017,9402447,4676178,4726269
276,"Germany",2010,80894785,39656447,41238351,9812263,4848689,4963574
276,"Germany",2015,81707789,40186938,41520861,10220418,5037961,5182457
276,"Germany",2017,82114224,40434856,41679369,12165083,6055267,6109816
316,"Guam",1990,130482,69607,60873,69755,39364,30391
316,"Guam",1995,145561,75854,69705,71912,38822,33090
316,"Guam",2000,155329,79427,75896,74070,38280,35790
316,"Guam",2005,158402,80748,77658,74743,38602,36141
316,"Guam",2010,159444,81023,78416,75416,38924,36492
316,"Guam",2015,161797,81994,79804,76089,39246,36843
316,"Guam",2017,164229,83162,81075,78027,40246,37781
300,"Greece",1990,10248537,5081916,5166614,618139,330038,288101
300,"Greece",1995,10789375,5362298,5427077,857850,445004,412846
300,"Greece",2000,11142119,5539395,5602734,1111665,559794,551871
300,"Greece",2005,11301204,5595835,5705363,1190707,587677,603030
300,"Greece",2010,11446005,5642095,5803902,1321149,640731,680418
300,"Greece",2015,11217800,5523444,5694359,1242924,570528,672396
300,"Greece",2017,11159773,5492859,5666918,1220395,555797,664598
320,"Guatemala",1990,9263813,4603183,4660637,264257,112615,151642
320,"Guatemala",1995,10408489,5135767,5272719,156188,66913,89275
320,"Guatemala",2000,11650743,5716737,5934007,48119,21211,26908
320,"Guatemala",2005,13096028,6422517,6673511,57252,26064,31188
320,"Guatemala",2010,14630417,7186236,7444184,66384,30917,35467
320,"Guatemala",2015,16252429,7995000,8257425,78352,37136,41216
320,"Guatemala",2017,16913503,8324326,8589179,81528,38642,42886
324,"Guinea",1990,6041094,2987433,3053662,403621,201260,202361
324,"Guinea",1995,7871173,3904143,3967031,774505,386537,387968
324,"Guinea",2000,8808546,4386304,4422252,560075,279108,280967
324,"Guinea",2005,9679745,4838658,4841092,229611,111738,117873
324,"Guinea",2010,10794170,5399923,5394253,177998,92899,85099
324,"Guinea",2015,12091533,6059372,6032162,126386,74060,52326
324,"Guinea",2017,12717176,6376336,6340847,122796,72301,50495
328,"Guyana",1990,743309,366732,376574,4095,2200,1895
328,"Guyana",1995,761291,374783,386515,6352,3405,2947
328,"Guyana",2000,753301,374513,378784,8610,4611,3999
328,"Guyana",2005,750946,376240,374703,10868,5817,5051
328,"Guyana",2010,746556,373463,373096,13126,7023,6103
328,"Guyana",2015,768514,387050,381464,15384,8229,7155
328,"Guyana",2017,777859,392674,385180,15530,8308,7222
332,"Haiti",1990,7099732,3499596,3600131,19084,10606,8478
332,"Haiti",1995,7819806,3857962,3961846,22458,12635,9823
332,"Haiti",2000,8549200,4221290,4327906,25832,14664,11168
332,"Haiti",2005,9263404,4577045,4686363,30468,17413,13055
332,"Haiti",2010,9999617,4943177,5056431,35104,20162,14942
332,"Haiti",2015,10711061,5297427,5413644,39529,22774,16755
332,"Haiti",2017,10981229,5430016,5551208,40533,23353,17180
340,"Honduras",1990,4955328,2461240,2494090,270423,137573,132850
340,"Honduras",1995,5709051,2836471,2872578,149442,76077,73365
340,"Honduras",2000,6524283,3243899,3280385,28461,14581,13880
340,"Honduras",2005,7373430,3670226,3703204,27875,14444,13431
340,"Honduras",2010,8194778,4082934,4111848,27288,14306,12982
340,"Honduras",2015,8960829,4467193,4493630,38317,20116,18201
340,"Honduras",2017,9265067,4619586,4645485,38700,20318,18382
191,"Croatia",1990,4776372,2315813,2460557,475438,222531,252907
191,"Croatia",1995,4616763,2233193,2383567,674085,315733,358352
191,"Croatia",2000,4428072,2131746,2296327,585298,274823,310475
191,"Croatia",2005,4378057,2108401,2269656,579273,271645,307628
191,"Croatia",2010,4328153,2084697,2243454,573248,268466,304782
191,"Croatia",2015,4236016,2041032,2194982,575738,267272,308466
191,"Croatia",2017,4189353,2019424,2169930,560483,259274,301209
348,"Hungary",1990,10377651,4983948,5393697,347510,156185,191325
348,"Hungary",1995,10349838,4944192,5405653,322234,147202,175032
348,"Hungary",2000,10221051,4862654,5358401,296957,138219,158738
348,"Hungary",2005,10086465,4786311,5300159,366787,174216,192571
348,"Hungary",2010,9927840,4710604,5217246,436616,210212,226404
348,"Hungary",2015,9783925,4650332,5133594,475508,235719,239789
348,"Hungary",2017,9721559,4624521,5097037,503787,251937,251850
352,"Iceland",1990,255043,128057,126987,9584,4248,5336
352,"Iceland",1995,267629,134227,133400,12738,5727,7011
352,"Iceland",2000,280435,140339,140100,15892,7207,8685
352,"Iceland",2005,294979,147906,147070,25492,12413,13079
352,"Iceland",2010,320328,161382,158960,35091,17619,17472
352,"Iceland",2015,330243,165685,164552,39072,19070,20002
352,"Iceland",2017,335025,168097,166927,41853,20725,21128
356,"India",1990,870133480,450351812,419781676,7493204,3914396,3578808
356,"India",1995,960482795,497343783,463139016,6952238,3608978,3343260
356,"India",2000,1053050912,545513564,507537344,6411272,3303560,3107712
356,"India",2005,1144118674,593062002,551056671,5923642,3045693,2877949
356,"India",2010,1230980691,638471937,592508747,5436012,2787826,2648186
356,"India",2015,1309053980,678564294,630489690,5240960,2684680,2556280
356,"India",2017,1339180127,693958763,645221368,5188550,2657833,2530717
364,"Iran (Islamic Republic of)",1990,56226185,28651606,27574576,4291601,2456700,1834901
364,"Iran (Islamic Republic of)",1995,60575644,30736786,29838861,2937668,1705972,1231696
364,"Iran (Islamic Republic of)",2000,66131854,33530876,32600985,2803805,1662264,1141541
364,"Iran (Islamic Republic of)",2005,70421811,35963531,34458280,2568930,1410319,1158611
364,"Iran (Islamic Republic of)",2010,74567511,37716501,36851012,2761561,1571723,1189838
364,"Iran (Islamic Republic of)",2015,79360487,39941755,39418737,2726420,1445236,1281184
364,"Iran (Islamic Republic of)",2017,81162788,40816182,40346600,2699155,1430784,1268371
376,"Israel",1990,4500475,2246074,2254412,1632704,770777,861927
376,"Israel",1995,5333719,2634348,2699368,1792185,830330,961855
376,"Israel",2000,6013741,2963544,3050206,1851309,853712,997597
376,"Israel",2005,6602970,3257334,3345640,1889503,867805,1021698
376,"Israel",2010,7425959,3668088,3757868,1950615,890352,1060263
376,"Israel",2015,8064547,3999567,4064987,2011727,912899,1098828
376,"Israel",2017,8321570,4133315,4188262,1962123,890390,1071733
380,"Italy",1990,57127120,27784523,29342603,1428221,642414,785807
380,"Italy",1995,57255193,27804222,29450974,1774953,809553,965400
380,"Italy",2000,57293721,27797900,29495821,2121690,976691,1144999
380,"Italy",2005,58808483,28612037,30196444,3954785,1820290,2134495
380,"Italy",2010,59729807,29016922,30712878,5787898,2663889,3124009
380,"Italy",2015,59504212,28961673,30542539,5805325,2637798,3167527
380,"Italy",2017,59359900,28929140,30430767,5907461,2691899,3215562
384,"Cote d'Ivoire",1990,12267754,6369486,5898269,1816426,1011749,804677
384,"Cote d'Ivoire",1995,14540820,7526738,7014081,2076394,1150710,925684
384,"Cote d'Ivoire",2000,16686561,8609932,8076629,1994135,1104600,889535
384,"Cote d'Ivoire",2005,18336303,9401109,8935191,2010824,1113590,897234
384,"Cote d'Ivoire",2010,20401331,10408967,9992365,2095185,1160366,934819
384,"Cote d'Ivoire",2015,23108472,11728519,11379958,2175399,1204616,970783
384,"Cote d'Ivoire",2017,24294750,12307090,11987657,2197152,1216662,980490
368,"Iraq",1990,17469005,8814265,8654734,83638,55751,27887
368,"Iraq",1995,20208387,10190752,10017633,199460,114821,84639
368,"Iraq",2000,23565413,11889712,11675700,210525,120464,90061
368,"Iraq",2005,27008426,13650648,13357781,132915,80883,52032
368,"Iraq",2010,30762701,15549002,15213700,117389,72965,44424
368,"Iraq",2015,36115649,18275557,17840093,359381,209233,150148
368,"Iraq",2017,38274618,19375781,18898837,366568,213418,153150
392,"Japan",1990,124515561,61362636,63152925,1075626,547986,527640
392,"Japan",1995,126375466,62194754,64180716,1381097,672482,708615
392,"Japan",2000,127533934,62629568,64904361,1686567,796977,889590
392,"Japan",2005,128335767,62890489,65445278,2012916,924544,1088372
392,"Japan",2010,128551873,62879304,65672569,2134151,959860,1174291
392,"Japan",2015,127974958,62525946,65449013,2232189,1003955,1228234
392,"Japan",2017,127484450,62256276,65228175,2321476,1044113,1277363
388,"Jamaica",1990,2424242,1195350,1228896,20475,9981,10494
388,"Jamaica",1995,2537440,1254588,1282852,22713,11242,11471
388,"Jamaica",2000,2656864,1320061,1336798,24952,12503,12449
388,"Jamaica",2005,2744673,1358299,1386363,24314,12263,12051
388,"Jamaica",2010,2817210,1398927,1418292,23677,12024,11653
388,"Jamaica",2015,2871934,1429046,1442879,23167,11766,11401
388,"Jamaica",2017,2890299,1438145,1452148,23332,11850,11482
400,"Jordan",1990,3560582,1865301,1695283,1146349,586473,559876
400,"Jordan",1995,4572904,2391750,2181151,1537097,784725,752372
400,"Jordan",2000,5103130,2645207,2457925,1927845,982977,944868
400,"Jordan",2005,5714111,2948193,2765918,2325414,1183645,1141769
400,"Jordan",2010,7182390,3662927,3519460,2722983,1384313,1338670
400,"Jordan",2015,9159302,4640978,4518329,3112026,1567177,1544849
400,"Jordan",2017,9702353,4913207,4789150,3233553,1628377,1605176
404,"Kenya",1990,23402507,11649237,11753273,297292,160852,136440
404,"Kenya",1995,27346456,13594668,13751777,618745,322189,296556
404,"Kenya",2000,31450483,15619136,15831342,699139,348594,350545
404,"Kenya",2005,36048288,17909625,18138666,756894,391310,365584
404,"Kenya",2010,41350152,20553888,20796269,926959,459343,467616
404,"Kenya",2015,47236259,23477023,23759244,1084357,541644,542713
404,"Kenya",2017,49699862,24700717,24999137,1078572,538724,539848
417,"Kyrgyzstan",1990,4372890,2144650,2228241,623083,260416,362667
417,"Kyrgyzstan",1995,4566087,2252575,2313513,510296,213277,297019
417,"Kyrgyzstan",2000,4920718,2432994,2487724,389558,162815,226743
417,"Kyrgyzstan",2005,5075380,2515750,2559627,312897,129544,183353
417,"Kyrgyzstan",2010,5422337,2679705,2742637,231511,94348,137163
417,"Kyrgyzstan",2015,5865401,2908034,2957369,204382,82616,121766
417,"Kyrgyzstan",2017,6045117,2997513,3047601,200294,80964,119330
408,"Korea, Democratic People's Republic of",1990,20293054,9859249,10433808,34103,17393,16710
408,"Korea, Democratic People's Republic of",1995,21862299,10657909,11204391,35143,17562,17581
408,"Korea, Democratic People's Republic of",2000,22929075,11177728,11751350,36183,17731,18452
408,"Korea, Democratic People's Republic of",2005,23904167,11670344,12233823,40097,19749,20348
408,"Korea, Democratic People's Republic of",2010,24591599,12016471,12575133,44010,21766,22244
408,"Korea, Democratic People's Republic of",2015,25243917,12344958,12898958,48458,24110,24348
408,"Korea, Democratic People's Republic of",2017,25490965,12467897,13023069,48939,24350,24589
296,"Kiribati",1990,72412,35818,36588,2162,1107,1055
296,"Kiribati",1995,77730,38523,39202,2223,1139,1084
296,"Kiribati",2000,84406,41595,42816,2283,1188,1095
296,"Kiribati",2005,92325,45490,46836,2487,1312,1175
296,"Kiribati",2010,102652,50529,52117,2868,1512,1356
296,"Kiribati",2015,112407,55412,56998,2919,1539,1380
296,"Kiribati",2017,116398,57394,59005,3022,1594,1428
410,"Korea, Republic of",1990,42923131,21516498,21406632,43017,24211,18806
410,"Korea, Republic of",1995,45298611,22733181,22565426,123886,70758,53128
410,"Korea, Republic of",2000,47386312,23775808,23610503,244178,143181,100997
410,"Korea, Republic of",2005,48708497,24434757,24273747,485546,284034,201512
410,"Korea, Republic of",2010,49552855,24828498,24724347,919275,525031,394244
410,"Korea, Republic of",2015,50593662,25324659,25268999,1143087,641400,501687
410,"Korea, Republic of",2017,50982212,25510367,25471853,1151865,646326,505539
414,"Kuwait",1990,2099615,1193033,906582,1074391,654878,419513
414,"Kuwait",1995,1610651,935207,675444,921954,591452,330502
414,"Kuwait",2000,2050741,1198508,852238,1127640,761512,366128
414,"Kuwait",2005,2276623,1344277,932343,1333327,918580,414747
414,"Kuwait",2010,2998083,1733582,1264497,1871537,1309814,561723
414,"Kuwait",2015,3935794,2260980,1674808,2866136,1888220,977916
414,"Kuwait",2017,4136528,2375251,1761274,3123431,2123292,1000139
398,"Kazakhstan",1990,16540258,8029446,8510812,3619200,1666164,1953036
398,"Kazakhstan",1995,16034956,7770651,8264299,3245250,1494009,1751241
398,"Kazakhstan",2000,15057363,7243434,7813929,2871300,1321855,1549445
398,"Kazakhstan",2005,15541457,7487156,8054305,3102962,1473441,1629521
398,"Kazakhstan",2010,16398976,7927069,8471909,3334623,1625026,1709597
398,"Kazakhstan",2015,17749648,8595071,9154569,3546778,1758182,1788596
398,"Kazakhstan",2017,18204499,8816946,9387554,3635168,1801999,1833169
418,"Lao People's Democratic Republic",1990,4258472,2129857,2128615,22866,11806,11060
418,"Lao People's Democratic Republic",1995,4851923,2421122,2430800,23526,12199,11327
418,"Lao People's Democratic Republic",2000,5329304,2656944,2672354,21948,11564,10384
418,"Lao People's Democratic Republic",2005,5754026,2853959,2900065,20371,10930,9441
418,"Lao People's Democratic Republic",2010,6246274,3107387,3138888,32473,17424,15049
418,"Lao People's Democratic Republic",2015,6663967,3321589,3342385,44575,23917,20658
418,"Lao People's Democratic Republic",2017,6858160,3420932,3437233,45466,24396,21070
422,"Lebanon",1990,2703016,1333020,1369993,523693,267922,255771
422,"Lebanon",1995,3033394,1504023,1529368,608303,310613,297690
422,"Lebanon",2000,3235366,1605151,1630222,692913,353305,339608
422,"Lebanon",2005,3986852,2025936,1960921,756784,390331,366453
422,"Lebanon",2010,4337141,2211690,2125452,820655,427358,393297
422,"Lebanon",2015,5851479,2939287,2912201,1973204,948425,1024779
422,"Lebanon",2017,6082357,3051011,3031345,1939212,932449,1006763
428,"Latvia",1990,2664432,1241429,1423008,646007,290800,355207
428,"Latvia",1995,2508473,1155735,1352733,538093,234216,303877
428,"Latvia",2000,2384163,1095569,1288580,430178,177632,252546
428,"Latvia",2005,2251983,1032499,1219486,376725,154745,221980
428,"Latvia",2010,2118848,970263,1148578,313786,124675,189111
428,"Latvia",2015,1992663,914568,1078099,265418,104011,161407
428,"Latvia",2017,1949670,895418,1054254,256889,101028,155861
112,"Belarus",1990,10216846,4791426,5425422,1248977,572021,676956
112,"Belarus",1995,10142308,4754820,5387488,1186282,543307,642975
112,"Belarus",2000,9933609,4662623,5270991,1123586,514593,608993
112,"Belarus",2005,9621543,4491286,5130263,1106982,506988,599994
112,"Belarus",2010,9473071,4403462,5069608,1090378,499384,590994
112,"Belarus",2015,9485772,4413162,5072611,1082905,495961,586944
112,"Belarus",2017,9468338,4405973,5062365,1078652,494014,584638
440,"Lithuania",1990,3696034,1748949,1947083,349258,164585,184673
440,"Lithuania",1995,3626602,1708824,1917775,273587,128641,144946
440,"Lithuania",2000,3501835,1638982,1862857,214311,100546,113765
440,"Lithuania",2005,3344252,1553570,1790673,201209,94189,107020
440,"Lithuania",2010,3123803,1437952,1685859,160772,69606,91166
440,"Lithuania",2015,2931926,1350160,1581755,136021,57508,78513
440,"Lithuania",2017,2890297,1331613,1558678,124706,51850,72856
430,"Liberia",1990,2097232,1044013,1053226,94964,53924,41040
430,"Liberia",1995,2073482,1031947,1041531,208563,111647,96916
430,"Liberia",2000,2884522,1441421,1443101,151868,82129,69739
430,"Liberia",2005,3261230,1635086,1626140,87188,51183,36005
430,"Liberia",2010,3948125,1985387,1962749,99129,56885,42244
430,"Liberia",2015,4499621,2268288,2231332,113779,64879,48900
430,"Liberia",2017,4731906,2387360,2344548,98630,56241,42389
703,"Slovakia",1990,5288454,2581311,2707144,41295,18187,23108
703,"Slovakia",1995,5375470,2615784,2759686,69323,30531,38792
703,"Slovakia",2000,5399211,2621672,2777535,116376,51253,65123
703,"Slovakia",2005,5398963,2617477,2781485,130491,58716,71775
703,"Slovakia",2010,5404294,2621333,2782960,146319,66938,79381
703,"Slovakia",2015,5439318,2643669,2795652,177624,89011,88613
703,"Slovakia",2017,5447662,2648340,2799325,184642,93294,91348
438,"Liechtenstein",1990,28747,NA,NA,10906,5956,4950
438,"Liechtenstein",1995,30833,NA,NA,13311,7068,6243
438,"Liechtenstein",2000,33286,NA,NA,15483,7980,7503
438,"Liechtenstein",2005,34852,NA,NA,18898,9434,9464
438,"Liechtenstein",2010,36003,NA,NA,22342,10867,11475
438,"Liechtenstein",2015,37403,NA,NA,23799,11605,12194
438,"Liechtenstein",2017,37922,NA,NA,24683,12013,12670
434,"Libyan Arab Jamahiriya",1990,4436661,2338935,2097728,457075,242707,214368
434,"Libyan Arab Jamahiriya",1995,4948798,2591816,2356980,508041,300906,207135
434,"Libyan Arab Jamahiriya",2000,5355751,2780260,2575492,567436,368950,198486
434,"Libyan Arab Jamahiriya",2005,5792688,2986999,2805685,625212,445597,179615
434,"Libyan Arab Jamahiriya",2010,6169140,3149563,3019589,683998,489737,194261
434,"Libyan Arab Jamahiriya",2015,6234955,3148308,3086641,771146,549153,221993
434,"Libyan Arab Jamahiriya",2017,6374616,3213430,3161194,788419,561454,226965
450,"Madagascar",1990,11598633,5791130,5807517,23917,13348,10569
450,"Madagascar",1995,13475400,6715768,6759635,21177,11901,9276
450,"Madagascar",2000,15766806,7850485,7916321,23541,13276,10265
450,"Madagascar",2005,18336724,9130493,9206229,26058,14744,11314
450,"Madagascar",2010,21151640,10536295,10615345,28905,16410,12495
450,"Madagascar",2015,24234088,12081791,12152289,32075,18270,13805
450,"Madagascar",2017,25570895,12752052,12818840,33844,19278,14566
474,"Martinique",1990,358449,173032,185425,38705,19091,19614
474,"Martinique",1995,368732,176063,192665,46599,22271,24328
474,"Martinique",2000,387004,181786,205230,54492,25451,29041
474,"Martinique",2005,397047,185069,211978,57034,25891,31143
474,"Martinique",2010,394910,182361,212554,59575,26330,33245
474,"Martinique",2015,385842,176055,209792,61731,26989,34742
474,"Martinique",2017,384896,175135,209772,61579,26923,34656
496,"Mongolia",1990,2184145,1078252,1105887,6718,3419,3299
496,"Mongolia",1995,2298039,1138463,1159573,7424,3959,3465
496,"Mongolia",2000,2397436,1195613,1201827,8206,4564,3642
496,"Mongolia",2005,2526446,1256932,1269518,11475,7576,3899
496,"Mongolia",2010,2712650,1345895,1366755,16061,11880,4181
496,"Mongolia",2015,2976877,1473946,1502930,17620,12857,4763
496,"Mongolia",2017,3075647,1521444,1554199,18204,13284,4920
500,"Montserrat",1990,10730,NA,NA,2013,1029,984
500,"Montserrat",1995,10233,NA,NA,1612,825,787
500,"Montserrat",2000,4955,NA,NA,1211,622,589
500,"Montserrat",2005,4778,NA,NA,1244,639,605
500,"Montserrat",2010,4944,NA,NA,1277,657,620
500,"Montserrat",2015,5124,NA,NA,1351,696,655
500,"Montserrat",2017,5177,NA,NA,1364,703,661
807,"The former Yugoslav Republic of Macedonia",1990,1996228,1004092,992126,95142,39661,55481
807,"The former Yugoslav Republic of Macedonia",1995,1983252,995293,987966,109343,45581,63762
807,"The former Yugoslav Republic of Macedonia",2000,2034819,1019342,1015481,125665,52385,73280
807,"The former Yugoslav Republic of Macedonia",2005,2060272,1029767,1030511,127667,53220,74447
807,"The former Yugoslav Republic of Macedonia",2010,2070739,1034490,1036243,129701,54067,75634
807,"The former Yugoslav Republic of Macedonia",2015,2079308,1039511,1039802,130730,54496,76234
807,"The former Yugoslav Republic of Macedonia",2017,2083160,1041432,1041735,130972,54597,76375
466,"Mali",1990,8465188,4180008,4285177,160736,82049,78687
466,"Mali",1995,9604450,4751072,4853373,176187,90871,85316
466,"Mali",2000,10967690,5440204,5527488,189475,97752,91723
466,"Mali",2005,12798763,6370826,6427935,256797,132244,124553
466,"Mali",2010,15075085,7530904,7544177,336607,172879,163728
466,"Mali",2015,17467905,8735645,8732268,365145,187111,178034
466,"Mali",2017,18541980,9279062,9262915,383721,196630,187091
504,"Morocco",1990,24879136,12413010,12466120,54895,29024,25871
504,"Morocco",1995,27075232,13469051,13606180,50360,26264,24096
504,"Morocco",2000,28849621,14293982,14555638,53034,27233,25801
504,"Morocco",2005,30521070,15075319,15445757,54379,27543,26836
504,"Morocco",2010,32409639,15972814,16436823,70909,35738,35171
504,"Morocco",2015,34803322,17220410,17582909,92424,46387,46037
504,"Morocco",2017,35739580,17701048,18038542,95835,48099,47736
480,"Mauritius",1990,1055868,526543,529326,3613,1763,1850
480,"Mauritius",1995,1128673,562649,566027,7493,3228,4265
480,"Mauritius",2000,1185145,587693,597454,15543,5705,9838
480,"Mauritius",2005,1222003,605620,616390,19647,8943,10704
480,"Mauritius",2010,1247955,618578,629375,24836,13188,11648
480,"Mauritius",2015,1259456,623795,635662,28585,15832,12753
480,"Mauritius",2017,1265138,625783,639364,28713,15903,12810
478,"Mauritania",1990,2030140,1012198,1017953,111650,57569,54081
478,"Mauritania",1995,2327075,1159734,1167347,89562,47015,42547
478,"Mauritania",2000,2709359,1354129,1355236,57366,31163,26203
478,"Mauritania",2005,3130720,1568249,1562468,58119,32588,25531
478,"Mauritania",2010,3609543,1812440,1797102,84679,48605,36074
478,"Mauritania",2015,4182341,2106193,2076145,166552,94070,72482
478,"Mauritania",2017,4420184,2227764,2192420,168438,95136,73302
470,"Malta",1990,364431,180092,184345,15077,7012,8065
470,"Malta",1995,380305,188502,191802,17740,8366,9374
470,"Malta",2000,396668,197661,199012,21521,10289,11232
470,"Malta",2005,406787,202503,204287,24560,11899,12661
470,"Malta",2010,416110,207165,208949,33008,17118,15890
470,"Malta",2015,427616,214501,213116,42430,22648,19782
470,"Malta",2017,430835,216375,214454,45539,24308,21231
512,"Oman",1990,1812160,1008695,803468,304000,242477,61523
512,"Oman",1995,2204283,1307243,897040,539643,417444,122199
512,"Oman",2000,2267991,1273251,994740,623608,488389,135219
512,"Oman",2005,2511269,1420351,1090914,666160,527842,138318
512,"Oman",2010,3041460,1834557,1206907,816221,658746,157475
512,"Oman",2015,4199810,2723157,1476654,1814591,1500622,313969
512,"Oman",2017,4636262,3052699,1583559,2073292,1741326,331966
462,"Maldives",1990,223215,114440,108780,8689,4777,3912
462,"Maldives",1995,254082,128649,125426,18510,9243,9267
462,"Maldives",2000,280384,141957,138433,27092,14907,12185
462,"Maldives",2005,318836,168064,150784,45045,27079,17966
462,"Maldives",2010,364511,199635,164873,54659,41712,12947
462,"Maldives",2015,418403,236665,181741,64273,56345,7928
462,"Maldives",2017,436330,248102,188231,67026,58759,8267
484,"Mexico",1990,85357874,42450710,42907163,695674,348353,347321
484,"Mexico",1995,94045579,46694161,47351432,458549,229589,228960
484,"Mexico",2000,101719673,50506620,51213048,538051,270896,267155
484,"Mexico",2005,108472228,53945653,54526576,712487,359642,352845
484,"Mexico",2010,117318941,58388317,58930623,969538,490691,478847
484,"Mexico",2015,125890949,62677416,63213534,1193155,604669,588486
484,"Mexico",2017,129163276,64311945,64851331,1224169,620387,603782
458,"Malaysia",1990,18038321,9177163,8861156,695920,405808,290112
458,"Malaysia",1995,20495597,10432748,10062856,937368,534964,402404
458,"Malaysia",2000,23185608,11812507,11373103,1277223,712912,564311
458,"Malaysia",2005,25659393,13148877,12510515,1722344,995607,726737
458,"Malaysia",2010,28112289,14487868,13624432,2406011,1437206,968805
458,"Malaysia",2015,30723155,15876923,14846228,2650617,1601033,1049584
458,"Malaysia",2017,31624264,16325476,15298794,2703629,1633054,1070575
508,"Mozambique",1990,13247649,6327648,6920006,122332,66060,56272
508,"Mozambique",1995,15759132,7518006,8241124,168256,91210,77046
508,"Mozambique",2000,18067687,8666202,9401476,195702,103175,92527
508,"Mozambique",2005,20923070,10106007,10817067,204830,102500,102330
508,"Mozambique",2010,24221405,11761394,12460012,214612,104676,109936
508,"Mozambique",2015,28010691,13660351,14350344,238930,116916,122014
508,"Mozambique",2017,29668834,14490336,15178502,246954,120843,126111
454,"Malawi",1990,9437553,4637660,4799887,1127724,546520,581204
454,"Malawi",1995,9909088,4892642,5016449,241624,116198,125426
454,"Malawi",2000,11376172,5610354,5765807,232620,111530,121090
454,"Malawi",2005,13039711,6435982,6603728,221661,105931,115730
454,"Malawi",2010,15167095,7498804,7668292,217722,103869,113853
454,"Malawi",2015,17573607,8702133,8871473,232803,110893,121910
454,"Malawi",2017,18622104,9225154,9396953,237104,112936,124168
540,"New Caledonia",1990,169787,86617,83173,37673,20885,16788
540,"New Caledonia",1995,190732,97383,93347,43662,23908,19754
540,"New Caledonia",2000,212871,107803,105071,49651,26932,22719
540,"New Caledonia",2005,232686,117002,115683,55405,29909,25496
540,"New Caledonia",2010,251037,127335,123692,61158,32886,28272
540,"New Caledonia",2015,269091,135820,133270,64290,34621,29669
540,"New Caledonia",2017,276255,139174,137086,66001,35543,30458
570,"Niue",1990,2329,NA,NA,461,245,216
570,"Niue",1995,2165,NA,NA,480,257,223
570,"Niue",2000,1899,NA,NA,498,268,230
570,"Niue",2005,1683,NA,NA,522,282,240
570,"Niue",2010,1630,NA,NA,545,295,250
570,"Niue",2015,1629,NA,NA,557,302,255
570,"Niue",2017,1618,NA,NA,553,300,253
562,"Niger",1990,8012861,3911275,4101582,115464,55222,60242
562,"Niger",1995,9477333,4659109,4818228,145999,69751,76248
562,"Niger",2000,11352973,5634643,5718338,122260,58192,64068
562,"Niger",2005,13618449,6784789,6833662,124461,59170,65291
562,"Niger",2010,16425578,8209607,8215975,126464,60033,66431
562,"Niger",2015,19896965,9967702,9929261,252998,119915,133083
562,"Niger",2017,21477348,10769778,10707568,295610,140113,155497
533,"Aruba",1990,62149,30659,31493,14444,6429,8015
533,"Aruba",1995,80324,39616,40708,22274,9974,12300
533,"Aruba",2000,90853,43847,47019,30104,13519,16585
533,"Aruba",2005,100031,47574,52454,32540,14559,17981
533,"Aruba",2010,101669,48465,53200,34327,15311,19016
533,"Aruba",2015,104341,49597,54742,36114,16108,20006
533,"Aruba",2017,105264,49978,55278,36356,16193,20163
660,"Anguilla",1990,8334,NA,NA,2570,1258,1312
660,"Anguilla",1995,9802,NA,NA,3317,1584,1733
660,"Anguilla",2000,11070,NA,NA,4063,1910,2153
660,"Anguilla",2005,12638,NA,NA,4684,2210,2474
660,"Anguilla",2010,13769,NA,NA,5103,2415,2688
660,"Anguilla",2015,14611,NA,NA,5470,2593,2877
660,"Anguilla",2017,14909,NA,NA,5579,2646,2933
56,"Belgium",1990,10006544,4895870,5110675,904528,487446,417082
56,"Belgium",1995,10186305,4985819,5200485,909769,481022,428747
56,"Belgium",2000,10282033,5034820,5247226,895900,465810,430090
56,"Belgium",2005,10546886,5174235,5372650,882031,450828,431203
56,"Belgium",2010,10938739,5371961,5566774,1119256,568348,550908
56,"Belgium",2015,11287940,5548634,5739297,1252380,635948,616432
56,"Belgium",2017,11429336,5635891,5793452,1268411,644089,624322
344,"Hong Kong",1990,5781459,2934787,2846675,2218473,1124544,1093929
344,"Hong Kong",1995,6140101,3077390,3062710,2443798,1175087,1268711
344,"Hong Kong",2000,6663654,3274389,3389280,2669122,1225629,1443493
344,"Hong Kong",2005,6827761,3275954,3551805,2721235,1185121,1536114
344,"Hong Kong",2010,7025221,3296188,3729032,2779950,1147539,1632411
344,"Hong Kong",2015,7245701,3349042,3896654,2838665,1119957,1718708
344,"Hong Kong",2017,7364883,3386765,3978118,2883051,1137469,1745582
580,"Northern Mariana Islands",1990,42538,NA,NA,26593,14261,12332
580,"Northern Mariana Islands",1995,56278,NA,NA,32376,15847,16529
580,"Northern Mariana Islands",2000,69094,NA,NA,40122,17387,22735
580,"Northern Mariana Islands",2005,63744,NA,NA,37542,15977,21565
580,"Northern Mariana Islands",2010,54424,NA,NA,24168,10223,13945
580,"Northern Mariana Islands",2015,54816,NA,NA,21648,9100,12548
580,"Northern Mariana Islands",2017,55144,NA,NA,21777,9155,12622
234,"Faroe Islands",1990,47594,NA,NA,4285,2440,1845
234,"Faroe Islands",1995,46040,NA,NA,2900,1575,1325
234,"Faroe Islands",2000,47258,NA,NA,3593,1921,1672
234,"Faroe Islands",2005,48285,NA,NA,4583,2450,2133
234,"Faroe Islands",2010,48550,NA,NA,5096,2700,2396
234,"Faroe Islands",2015,48965,NA,NA,5517,2795,2722
234,"Faroe Islands",2017,49290,NA,NA,5735,2940,2795
20,"Andorra",1990,54509,NA,NA,38904,20810,18094
20,"Andorra",1995,63850,NA,NA,40525,21451,19074
20,"Andorra",2000,65390,NA,NA,42146,22092,20054
20,"Andorra",2005,78867,NA,NA,50298,26559,23739
20,"Andorra",2010,84449,NA,NA,52053,27486,24567
20,"Andorra",2015,78014,NA,NA,42082,22221,19861
20,"Andorra",2017,76965,NA,NA,41039,21560,19479
292,"Gibraltar",1990,29164,NA,NA,8709,4528,4181
292,"Gibraltar",1995,30147,NA,NA,8381,4196,4185
292,"Gibraltar",2000,31180,NA,NA,8054,3865,4189
292,"Gibraltar",2005,32085,NA,NA,9211,4518,4693
292,"Gibraltar",2010,33189,NA,NA,10369,5171,5198
292,"Gibraltar",2015,34228,NA,NA,11065,5591,5474
292,"Gibraltar",2017,34571,NA,NA,11152,5635,5517
833,"Isle of Man",1990,68429,NA,NA,34769,16371,18398
833,"Isle of Man",1995,70070,NA,NA,36886,17548,19338
833,"Isle of Man",2000,72554,NA,NA,39002,18725,20277
833,"Isle of Man",2005,76118,NA,NA,41475,20214,21261
833,"Isle of Man",2010,80072,NA,NA,43447,21361,22086
833,"Isle of Man",2015,83167,NA,NA,45221,22393,22828
833,"Isle of Man",2017,84287,NA,NA,45872,22716,23156
442,"Luxembourg",1990,381791,186800,194980,113795,56062,57733
442,"Luxembourg",1995,408149,200387,207758,126106,62292,63814
442,"Luxembourg",2000,436103,214787,221319,139750,69286,70464
442,"Luxembourg",2005,457842,225935,231913,150618,74951,75667
442,"Luxembourg",2010,507889,252297,255593,248888,126129,122759
442,"Luxembourg",2015,566741,284441,282300,260573,132428,128145
442,"Luxembourg",2017,583455,293227,290231,264073,134207,129866
446,"Macau",1990,343935,169898,174043,205047,96379,108668
446,"Macau",1995,385686,186935,198750,224929,103660,121269
446,"Macau",2000,427979,205004,222968,240791,109391,131400
446,"Macau",2005,482559,229249,253316,279308,130387,148921
446,"Macau",2010,536969,257686,279284,318506,146407,172099
446,"Macau",2015,600942,288256,312692,342703,155692,187011
446,"Macau",2017,622567,298823,323743,353654,160668,192986
492,"Monaco",1990,29439,NA,NA,20359,9471,10888
492,"Monaco",1995,30691,NA,NA,21060,9955,11105
492,"Monaco",2000,32082,NA,NA,21787,10458,11329
492,"Monaco",2005,33793,NA,NA,21312,10322,10990
492,"Monaco",2010,37094,NA,NA,21132,10325,10807
492,"Monaco",2015,38307,NA,NA,21042,10326,10716
492,"Monaco",2017,38695,NA,NA,21255,10431,10824
275,"Palestine",1990,2100883,1063214,1037668,288332,132101,156231
275,"Palestine",1995,2617702,1326210,1291485,281767,128328,153439
275,"Palestine",2000,3223009,1633971,1589044,275202,124555,150647
275,"Palestine",2005,3576170,1813598,1762570,266617,119621,146996
275,"Palestine",2010,4066829,2062524,2004302,258032,114688,143344
275,"Palestine",2015,4662884,2364812,2298072,255507,113237,142270
275,"Palestine",2017,4920724,2495470,2425251,253735,112452,141283
499,"Montenegro",1990,615002,306214,308789,NA,NA,NA
499,"Montenegro",1995,620414,308088,312330,NA,NA,NA
499,"Montenegro",2000,613560,303053,310503,NA,NA,NA
499,"Montenegro",2005,616388,302885,313508,NA,NA,NA
499,"Montenegro",2010,624285,307613,316672,78507,31636,46871
499,"Montenegro",2015,628178,309829,318348,82541,33547,48994
499,"Montenegro",2017,628960,310309,318650,70984,27813,43171
175,"Mayotte",1990,94784,48453,46326,15229,8780,6449
175,"Mayotte",1995,123181,62551,60635,26316,14679,11637
175,"Mayotte",2000,150331,76060,74271,45474,23546,21928
175,"Mayotte",2005,178098,87776,90327,63176,31364,31812
175,"Mayotte",2010,208718,102033,106683,72757,34500,38257
175,"Mayotte",2015,240020,117875,122136,73992,34235,39757
175,"Mayotte",2017,253045,124404,128643,74399,34424,39975
248,"Åland Islands",NA,NA,NA,NA,NA,NA,NA
574,"Norfolk Island",NA,NA,NA,NA,NA,NA,NA
166,"Cocos (Keeling) Islands",NA,NA,NA,NA,NA,NA,NA
10,"Antarctica",NA,NA,NA,NA,NA,NA,NA
74,"Bouvet Island",NA,NA,NA,NA,NA,NA,NA
260,"French Southern and Antarctic Lands",NA,NA,NA,NA,NA,NA,NA
334,"Heard Island and McDonald Islands",NA,NA,NA,NA,NA,NA,NA
86,"British Indian Ocean Territory",NA,NA,NA,NA,NA,NA,NA
162,"Christmas Island",NA,NA,NA,NA,NA,NA,NA
581,"United States Minor Outlying Islands",NA,NA,NA,NA,NA,NA,NA
548,"Vanuatu",1990,146634,75409,71224,2308,1269,1039
548,"Vanuatu",1995,168235,86304,81931,2461,1295,1166
548,"Vanuatu",2000,185063,94639,90418,2626,1320,1306
548,"Vanuatu",2005,209370,106801,102576,2800,1398,1402
548,"Vanuatu",2010,236295,119970,116340,2991,1487,1504
548,"Vanuatu",2015,264603,134007,130596,3187,1583,1604
548,"Vanuatu",2017,276244,139780,136466,3245,1612,1633
566,"Nigeria",1990,95269988,47928865,47341122,456621,256166,200455
566,"Nigeria",1995,108011465,54379689,53631778,462999,258091,204908
566,"Nigeria",2000,122352009,61684870,60667141,487882,270211,217671
566,"Nigeria",2005,138939478,70159951,68779523,969294,564384,404910
566,"Nigeria",2010,158578261,80204204,78374055,988679,575671,413008
566,"Nigeria",2015,181181744,91768732,89413015,1199115,657887,541228
566,"Nigeria",2017,190886311,96729235,94157078,1235088,677624,557464
528,"Netherlands",1990,14965448,7402106,7563336,1182263,592343,589920
528,"Netherlands",1995,15467851,7660507,7807345,1346164,668236,677928
528,"Netherlands",2000,15926188,7888740,8037448,1556337,765302,791035
528,"Netherlands",2005,16367158,8116075,8251078,1736127,843444,892683
528,"Netherlands",2010,16682917,8284404,8398523,1832510,881264,951246
528,"Netherlands",2015,16938499,8420387,8518105,1996318,952313,1044005
528,"Netherlands",2017,17035938,8476271,8559673,2056520,983586,1072934
578,"Norway",1990,4247285,2099924,2147362,192587,99562,93025
578,"Norway",1995,4366995,2159604,2207392,233302,117222,116080
578,"Norway",2000,4499367,2229011,2270364,292440,144826,147614
578,"Norway",2005,4632364,2298246,2334113,361144,176444,184700
578,"Norway",2010,4885878,2442442,2443436,526799,268505,258294
578,"Norway",2015,5199836,2617868,2581959,746375,389370,357005
578,"Norway",2017,5305383,2676759,2628624,798944,417087,381857
524,"Nepal",1990,18749406,9303384,9446031,429974,125966,304008
524,"Nepal",1995,21396384,10799491,10596893,690225,217088,473137
524,"Nepal",2000,23740911,11806324,11934587,717900,241959,475941
524,"Nepal",2005,25640287,12722375,12917903,679457,235203,444254
524,"Nepal",2010,27023137,13181560,13841577,578657,189518,389139
524,"Nepal",2015,28656282,13903375,14752912,509855,156556,353299
524,"Nepal",2017,29304998,14225604,15079386,502670,153928,348742
520,"Nauru",1990,9155,NA,NA,2815,1506,1309
520,"Nauru",1995,9969,NA,NA,2605,1395,1210
520,"Nauru",2000,10037,NA,NA,2394,1283,1111
520,"Nauru",2005,10114,NA,NA,2253,1208,1045
520,"Nauru",2010,10025,NA,NA,2112,1133,979
520,"Nauru",2015,11260,NA,NA,3678,2297,1381
520,"Nauru",2017,11359,NA,NA,3710,2317,1393
740,"Suriname",1990,407472,206947,200521,18031,9731,8300
740,"Suriname",1995,443724,225118,218600,22270,12057,10213
740,"Suriname",2000,472390,238329,234066,27506,14892,12614
740,"Suriname",2005,498946,251306,247646,33664,18339,15325
740,"Suriname",2010,526103,264557,261538,39713,21659,18054
740,"Suriname",2015,553208,277794,275410,46836,25569,21267
740,"Suriname",2017,563402,282735,280662,47699,26041,21658
558,"Nicaragua",1990,4144565,2055398,2089160,41421,20860,20561
558,"Nicaragua",1995,4612228,2284522,2327712,26619,13364,13255
558,"Nicaragua",2000,5026796,2487083,2539701,30389,15423,14966
558,"Nicaragua",2005,5379328,2655387,2723934,34918,17773,17145
558,"Nicaragua",2010,5737723,2826852,2910867,37333,19128,18205
558,"Nicaragua",2015,6082035,2997971,3084060,40262,20723,19539
558,"Nicaragua",2017,6217581,3065366,3152216,41159,21185,19974
554,"New Zealand",1990,3398172,1672540,1725635,518047,258223,259824
554,"New Zealand",1995,3674936,1810954,1863986,588617,289230,299387
554,"New Zealand",2000,3858999,1893983,1965009,678813,329927,348886
554,"New Zealand",2005,4135355,2025748,2109605,839952,407690,432262
554,"New Zealand",2010,4370062,2145763,2224297,947443,459047,488396
554,"New Zealand",2015,4614532,2268961,2345566,1039736,502787,536949
554,"New Zealand",2017,4705818,2314022,2391793,1067423,516176,551247
600,"Paraguay",1990,4213742,2129647,2084088,195884,102816,93068
600,"Paraguay",1995,4760850,2407256,2353598,186570,97869,88701
600,"Paraguay",2000,5302700,2683484,2619221,176608,92052,84556
600,"Paraguay",2005,5795494,2934745,2860748,168243,87698,80545
600,"Paraguay",2010,6209877,3150390,3059482,160299,83394,76905
600,"Paraguay",2015,6639119,3369124,3269997,156462,81303,75159
600,"Paraguay",2017,6811297,3454924,3356370,160519,83412,77107
604,"Peru",1990,21826658,10905859,10920795,65025,32538,32487
604,"Peru",1995,24038760,12013122,12025644,56732,28061,28671
604,"Peru",2000,25914879,12950839,12964039,66293,32955,33338
604,"Peru",2005,27610410,13796304,13814102,77541,38746,38795
604,"Peru",2010,29373646,14675720,14697919,84066,42204,41862
604,"Peru",2015,31376671,15673112,15703566,91481,45805,45676
604,"Peru",2017,32165485,16065106,16100380,93780,46957,46823
586,"Pakistan",1990,107678614,55814381,51864229,6208204,3264380,2943824
586,"Pakistan",1995,122829148,63475179,59353964,3669308,1951223,1718085
586,"Pakistan",2000,138523285,71471143,67052146,4181912,2249960,1931952
586,"Pakistan",2005,153909667,79331874,74577799,3171132,1708514,1462618
586,"Pakistan",2010,170560182,87686774,82873404,3941586,2074443,1867143
586,"Pakistan",2015,189380513,97286329,92094177,3628956,1854136,1774820
586,"Pakistan",2017,197015955,101199351,95816601,3398154,1743606,1654548
616,"Poland",1990,37954553,18482033,19472521,1127771,482176,645595
616,"Poland",1995,38452632,18702795,19749850,964725,404049,560676
616,"Poland",2000,38550495,18715307,19835193,825251,338323,486928
616,"Poland",2005,38362666,18574061,19788613,722509,297039,425470
616,"Poland",2010,38323402,18529195,19794212,642417,262263,380154
616,"Poland",2015,38265226,18483758,19781463,611855,256623,355232
616,"Poland",2017,38170712,18433818,19736892,640937,274254,366683
591,"Panama",1990,2471009,1249013,1221989,62744,33148,29596
591,"Panama",1995,2739730,1382240,1357489,70848,36740,34108
591,"Panama",2000,3030347,1527025,1503311,83410,42437,40973
591,"Panama",2005,3330465,1676002,1654463,117563,59812,57751
591,"Panama",2010,3643222,1830166,1813054,157309,80931,76378
591,"Panama",2015,3969249,1990220,1979027,184710,94841,89869
591,"Panama",2017,4098587,2053740,2044845,190728,97931,92797
620,"Portugal",1990,9953327,4794911,5158421,435782,209922,225860
620,"Portugal",1995,10149735,4892751,5256977,532822,259337,273485
620,"Portugal",2000,10355117,4996842,5358266,651472,320319,331153
620,"Portugal",2005,10565723,5110138,5455583,771184,376774,394410
620,"Portugal",2010,10652321,5100019,5552306,762825,371536,391289
620,"Portugal",2015,10418473,4935968,5482495,864814,398390,466424
620,"Portugal",2017,10329506,4888487,5441016,880188,410655,469533
598,"Papua New Guinea",1990,4313059,2193466,2119592,32720,18793,13927
598,"Papua New Guinea",1995,4894276,2486449,2407829,33526,19832,13694
598,"Papua New Guinea",2000,5572222,2831171,2741051,25101,15624,9477
598,"Papua New Guinea",2005,6314709,3210005,3104704,29967,18942,11025
598,"Papua New Guinea",2010,7108239,3615000,3493248,25424,16370,9054
598,"Papua New Guinea",2015,7919825,4028825,3891001,30782,19538,11244
598,"Papua New Guinea",2017,8251162,4197481,4053686,32389,20558,11831
624,"Guinea-Bissau",1990,1012280,493914,518372,15368,7689,7679
624,"Guinea-Bissau",1995,1137122,555849,581272,27961,13833,14128
624,"Guinea-Bissau",2000,1243229,608282,634944,20450,10155,10295
624,"Guinea-Bissau",2005,1380838,674287,706553,20736,10298,10438
624,"Guinea-Bissau",2010,1555880,762680,793189,21061,10307,10754
624,"Guinea-Bissau",2015,1770526,870333,900195,22333,10826,11507
624,"Guinea-Bissau",2017,1861283,915797,945479,23405,11346,12059
634,"Qatar",1990,476445,319021,157421,309753,225932,83821
634,"Qatar",1995,513455,338474,174974,361673,269972,91701
634,"Qatar",2000,592267,386343,205925,359697,274242,85455
634,"Qatar",2005,864863,584403,280454,646026,498428,147598
634,"Qatar",2010,1779676,1349480,430199,1456413,1206571,249842
634,"Qatar",2015,2481539,1871168,610372,1687640,1416361,271279
634,"Qatar",2017,2639211,1981344,657869,1721392,1444688,276704
638,"Reunion",1990,610582,298614,311970,57210,30724,26486
638,"Reunion",1995,673541,329007,344536,77159,40710,36449
638,"Reunion",2000,736710,359525,377189,100678,52264,48414
638,"Reunion",2005,791598,388455,403143,115076,59196,55880
638,"Reunion",2010,830519,402132,428375,123029,62707,60322
638,"Reunion",2015,863363,418093,445266,127209,64537,62672
638,"Reunion",2017,876562,424498,452067,129153,65524,63629
642,"Romania",1990,23489373,11579611,11909758,135825,57601,78224
642,"Romania",1995,22965111,11284362,11680747,135037,63282,71755
642,"Romania",2000,22128128,10825158,11302968,126949,60428,66521
642,"Romania",2005,21431018,10445870,10985155,145162,66264,78898
642,"Romania",2010,20440347,9924158,10516190,166126,81861,84265
642,"Romania",2015,19876621,9633206,10243414,281048,146758,134290
642,"Romania",2017,19679306,9534444,10144869,370753,196804,173949
498,"Republic of Moldova",1990,4364116,2080056,2284057,544162,239616,304546
498,"Republic of Moldova",1995,4339082,2072507,2266579,367231,161706,205525
498,"Republic of Moldova",2000,4201089,2010771,2190316,247828,109129,138699
498,"Republic of Moldova",2005,4157699,1991243,2166465,173957,76600,97357
498,"Republic of Moldova",2010,4084481,1963731,2120759,157668,60541,97127
498,"Republic of Moldova",2015,4065980,1953406,2112571,142904,50545,92359
498,"Republic of Moldova",2017,4051212,1943816,2107401,140045,49534,90511
608,"Philippines",1990,61947348,31292544,30654798,154071,81347,72724
608,"Philippines",1995,69835715,35226555,34609159,207345,107524,99821
608,"Philippines",2000,77991569,39280391,38711185,318095,161904,156191
608,"Philippines",2005,86274237,43361572,42912666,257468,133023,124445
608,"Philippines",2010,93726624,47309832,46416787,208599,107933,100666
608,"Philippines",2015,101716359,51237883,50478481,211862,109783,102079
608,"Philippines",2017,104918090,52800815,52117269,218530,113239,105291
630,"Puerto Rico",1990,3517975,1703699,1814284,321909,153354,168555
630,"Puerto Rico",1995,3689641,1780325,1909322,338067,160739,177328
630,"Puerto Rico",2000,3796977,1827540,1969440,355038,168480,186558
630,"Puerto Rico",2005,3765399,1807776,1957626,352144,166780,185364
630,"Puerto Rico",2010,3716693,1786149,1930540,304969,142939,162030
630,"Puerto Rico",2015,3673728,1765703,1908028,280494,130916,149578
630,"Puerto Rico",2017,3663131,1760829,1902306,273494,127649,145845
643,"Russia",1990,147564066,69085178,78478901,11524948,5655422,5869526
643,"Russia",1995,148288839,69568873,78719963,11928927,5925452,6003475
643,"Russia",2000,146396514,68509481,77887024,11900297,5982851,5917446
643,"Russia",2005,143618185,66834749,76783441,11667588,5806597,5860991
643,"Russia",2010,143153869,66388824,76765050,11194710,5514401,5680309
643,"Russia",2015,143888004,66847575,77040422,11643276,5715211,5928065
643,"Russia",2017,143989754,66917298,77072462,11651509,5719253,5932256
646,"Rwanda",1990,7235798,3564805,3670996,159869,80690,79179
646,"Rwanda",1995,5928078,2875677,3052413,233200,117931,115269
646,"Rwanda",2000,8025703,3914961,4110739,347076,175685,171391
646,"Rwanda",2005,8991735,4394718,4597014,432797,217027,215770
646,"Rwanda",2010,10246842,5017009,5229828,436787,218425,218362
646,"Rwanda",2015,11629553,5701230,5928316,441525,220017,221508
646,"Rwanda",2017,12208407,5986523,6221884,443088,220796,222292
682,"Saudi Arabia",1990,16326815,9144958,7181852,4998445,3324873,1673572
682,"Saudi Arabia",1995,18735841,10394932,8340914,5122702,3416485,1706217
682,"Saudi Arabia",2000,20764312,11309223,9455086,5263387,3517768,1745619
682,"Saudi Arabia",2005,23905654,13304966,10600690,6501819,4469805,2032014
682,"Saudi Arabia",2010,27425676,15400643,12025048,8429956,5933281,2496675
682,"Saudi Arabia",2015,31557144,17892693,13664437,10771366,7461502,3309864
682,"Saudi Arabia",2017,32938213,18797915,14140296,12185284,8341564,3843720
659,"Saint Kitts and Nevis",1990,40834,NA,NA,3210,1642,1568
659,"Saint Kitts and Nevis",1995,42891,NA,NA,4248,2196,2052
659,"Saint Kitts and Nevis",2000,45374,NA,NA,5871,3068,2803
659,"Saint Kitts and Nevis",2005,48611,NA,NA,6682,3501,3181
659,"Saint Kitts and Nevis",2010,51445,NA,NA,7245,3806,3439
659,"Saint Kitts and Nevis",2015,54288,NA,NA,7443,3916,3527
659,"Saint Kitts and Nevis",2017,55345,NA,NA,7587,3992,3595
690,"Seychelles",1990,70624,35226,35398,3721,2204,1517
690,"Seychelles",1995,76703,38389,38312,5148,3021,2127
690,"Seychelles",2000,81151,40421,40731,6574,3837,2737
690,"Seychelles",2005,88744,44341,44406,8997,5820,3177
690,"Seychelles",2010,91405,47139,44262,11420,7804,3616
690,"Seychelles",2015,93742,46453,47286,12791,8954,3837
690,"Seychelles",2017,94737,46684,48051,12926,9049,3877
710,"South Africa",1990,37560525,18548804,19011719,1163883,717227,446656
710,"South Africa",1995,42088165,20674307,21413849,1003807,611083,392724
710,"South Africa",2000,45728315,22440371,23287951,1001825,600032,401793
710,"South Africa",2005,48820586,23960662,24859928,1210936,712219,498717
710,"South Africa",2010,51584663,25329199,26255470,2096886,1216129,880757
710,"South Africa",2015,55291225,27149317,28141909,3816696,2122100,1694596
710,"South Africa",2017,56717156,27835724,28881426,4036696,2244421,1792275
426,"Lesotho",1990,1603938,774722,829213,8240,4318,3922
426,"Lesotho",1995,1761359,857827,903525,7204,3827,3377
426,"Lesotho",2000,1868699,899303,969393,6167,3335,2832
426,"Lesotho",2005,1949543,942243,1007296,6290,3402,2888
426,"Lesotho",2010,2040551,988404,1052151,6414,3469,2945
426,"Lesotho",2015,2174645,1054725,1119928,6572,3558,3014
426,"Lesotho",2017,2233339,1084317,1149016,6749,3654,3095
72,"Botswana",1990,1377912,677774,700144,27510,16614,10896
72,"Botswana",1995,1569094,773333,795760,40168,23517,16651
72,"Botswana",2000,1728340,851999,876330,57064,32891,24173
72,"Botswana",2005,1855852,916027,939818,88829,49695,39134
72,"Botswana",2010,2014866,996189,1018675,120912,66692,54220
72,"Botswana",2015,2209197,1091640,1117555,160644,87873,72771
72,"Botswana",2017,2291661,1132766,1158899,166430,91038,75392
686,"Senegal",1990,7555617,3760921,3794695,270410,138840,131570
686,"Senegal",1995,8746606,4342557,4404051,287654,147165,140489
686,"Senegal",2000,9884052,4864490,5019555,231901,121492,110409
686,"Senegal",2005,11251266,5517768,5733500,238298,124854,113444
686,"Senegal",2010,12916229,6323796,6592433,256092,135879,120213
686,"Senegal",2015,14976994,7350978,7626013,263242,139689,123553
686,"Senegal",2017,15850567,7787318,8063248,265601,140941,124660
705,"Slovenia",1990,2006479,973882,1032597,178077,89514,88563
705,"Slovenia",1995,1991472,965144,1026322,174419,90255,84164
705,"Slovenia",2000,1988499,970768,1017729,171018,90464,80554
705,"Slovenia",2005,1996281,974432,1021849,197276,107131,90145
705,"Slovenia",2010,2045168,1011590,1033574,253786,141285,112501
705,"Slovenia",2015,2074788,1029329,1045458,237616,134460,103156
705,"Slovenia",2017,2079976,1032825,1047153,244790,138120,106670
694,"Sierra Leone",1990,4312246,2129565,2182668,222242,123053,99189
694,"Sierra Leone",1995,4274819,2110602,2164216,105374,59683,45691
694,"Sierra Leone",2000,4564297,2253353,2310949,98241,54639,43602
694,"Sierra Leone",2005,5658379,2791064,2867310,149615,79638,69977
694,"Sierra Leone",2010,6458720,3189798,3268921,97452,53239,44213
694,"Sierra Leone",2015,7237025,3581569,3655459,91213,49962,41251
694,"Sierra Leone",2017,7557212,3742547,3814669,95248,52173,43075
702,"Singapore",1990,3012953,1515832,1497126,727262,345842,381420
702,"Singapore",1995,3478779,1751047,1727731,991492,456411,535081
702,"Singapore",2000,3913960,1955302,1958656,1351691,601671,750020
702,"Singapore",2005,4491042,2228974,2262062,1710594,758762,951832
702,"Singapore",2010,5074252,2503787,2570470,2164794,956856,1207938
702,"Singapore",2015,5535262,2733891,2801360,2543638,1122986,1420652
702,"Singapore",2017,5708844,2820720,2888113,2623404,1158202,1465202
706,"Somalia",1990,7397347,3721193,3676151,478294,244201,234093
706,"Somalia",1995,7704894,3867542,3837351,19527,10282,9245
706,"Somalia",2000,9011479,4516202,4495284,20087,10622,9465
706,"Somalia",2005,10409925,5211302,5198619,20670,11047,9623
706,"Somalia",2010,12053223,6017235,6035996,23995,12914,11081
706,"Somalia",2015,13908129,6929042,6979084,41578,21904,19674
706,"Somalia",2017,14742523,7343694,7398838,44868,23549,21319
724,"Spain",1990,39306102,19253995,20052110,821605,390448,431157
724,"Spain",1995,39890498,19531057,20359441,1020067,499114,520953
724,"Spain",2000,40903711,20077282,20826422,1657285,838058,819227
724,"Spain",2005,44042632,21722725,22319909,4107226,2140680,1966546
724,"Spain",2010,46788630,23132789,23655836,6280065,3238238,3041827
724,"Spain",2015,46397664,22768210,23629453,5891208,2884000,3007208
724,"Spain",2017,46354321,22729754,23624564,5947106,2892146,3054960
662,"Saint Lucia",1990,138185,67848,70332,5305,2616,2689
662,"Saint Lucia",1995,147044,72065,74981,7152,3560,3592
662,"Saint Lucia",2000,156949,76859,80086,9868,4950,4918
662,"Saint Lucia",2005,163714,80094,83616,11468,5783,5685
662,"Saint Lucia",2010,172580,84684,87890,12100,6106,5994
662,"Saint Lucia",2015,177206,86812,90395,12771,6446,6325
662,"Saint Lucia",2017,178844,87551,91294,12889,6506,6383
736,"Sudan",NA,NA,NA,NA,NA,NA,NA
752,"Sweden",1990,8567384,4232154,4335221,788767,383085,405682
752,"Sweden",1995,8836420,4366163,4470258,936022,450945,485077
752,"Sweden",2000,8881640,4392262,4489380,1003798,480211,523587
752,"Sweden",2005,9038623,4482090,4556537,1125790,538490,587300
752,"Sweden",2010,9390168,4677170,4712987,1337214,648004,689210
752,"Sweden",2015,9763565,4880005,4883557,1602522,786870,815652
752,"Sweden",2017,9910701,4959718,4950977,1747710,863205,884505
760,"Syrian Arab Republic",1990,12446171,6291882,6154286,714140,364077,350063
760,"Syrian Arab Republic",1995,14345492,7255799,7089692,830610,423115,407495
760,"Syrian Arab Republic",2000,16410848,8301810,8109037,832273,426633,405640
760,"Syrian Arab Republic",2005,18294611,9334249,8960364,876410,449470,426940
760,"Syrian Arab Republic",2010,21018834,10609286,10409563,1785115,911756,873359
760,"Syrian Arab Republic",2015,18734987,9476225,9258761,993940,507660,486280
760,"Syrian Arab Republic",2017,18269868,9231062,9038803,1013818,517813,496005
756,"Switzerland",1990,6674890,3258139,3416757,1392282,701110,691172
756,"Switzerland",1995,7018525,3427549,3590974,1478829,769043,709786
756,"Switzerland",2000,7167250,3501521,3665728,1570756,841855,728901
756,"Switzerland",2005,7410308,3627162,3783161,1805437,922387,883050
756,"Switzerland",2010,7831971,3856024,3975943,2075182,937911,1137271
756,"Switzerland",2015,8319769,4117089,4202685,2416394,1183243,1233151
756,"Switzerland",2017,8476005,4199491,4276504,2506394,1227314,1279080
780,"Trinidad and Tobago",1990,1221900,608618,613286,50666,23528,27138
780,"Trinidad and Tobago",1995,1255001,624879,630124,45994,21303,24691
780,"Trinidad and Tobago",2000,1267984,630611,637370,41753,19288,22465
780,"Trinidad and Tobago",2005,1296934,642930,654002,44812,20647,24165
780,"Trinidad and Tobago",2010,1328100,657278,670815,48226,23152,25074
780,"Trinidad and Tobago",2015,1360092,671085,689005,49883,24326,25557
780,"Trinidad and Tobago",2017,1369125,674468,694653,50214,24488,25726
764,"Thailand",1990,56582821,28027324,28555502,528693,283486,245207
764,"Thailand",1995,59491790,29546435,29945349,809720,426290,383430
764,"Thailand",2000,62958021,31095801,31862213,1257821,647728,610093
764,"Thailand",2005,65425470,32177314,33248152,2163447,1086166,1077281
764,"Thailand",2010,67208808,32937515,34271289,3224131,1624755,1599376
764,"Thailand",2015,68657600,33525445,35132148,3486526,1751187,1735339
764,"Thailand",2017,69037513,33664894,35372608,3588873,1802323,1786550
762,"Tajikistan",1990,5283728,2619107,2664624,428900,188128,240772
762,"Tajikistan",1995,5764712,2876224,2888485,348347,151957,196390
762,"Tajikistan",2000,6216205,3113661,3102545,299266,131420,167846
762,"Tajikistan",2005,6854176,3449921,3404267,280444,121381,159063
762,"Tajikistan",2010,7641630,3851349,3790275,278152,120124,158028
762,"Tajikistan",2015,8548651,4297346,4251299,275059,118597,156462
762,"Tajikistan",2017,8921343,4480617,4440726,273259,117821,155438
772,"Tokelau",1990,1608,NA,NA,270,150,120
772,"Tokelau",1995,1517,NA,NA,266,147,119
772,"Tokelau",2000,1554,NA,NA,262,144,118
772,"Tokelau",2005,1208,NA,NA,258,133,125
772,"Tokelau",2010,1140,NA,NA,429,206,223
772,"Tokelau",2015,1252,NA,NA,487,233,254
772,"Tokelau",2017,1300,NA,NA,504,242,262
776,"Tonga",1990,95153,48250,46908,2911,1488,1423
776,"Tonga",1995,96076,48709,47367,3274,1718,1556
776,"Tonga",2000,98082,49886,48198,3684,1981,1703
776,"Tonga",2005,101041,50671,50370,4301,2328,1973
776,"Tonga",2010,104137,52153,51981,4589,2493,2096
776,"Tonga",2015,106364,53334,53034,4877,2650,2227
776,"Tonga",2017,108020,54188,53830,4952,2691,2261
768,"Togo",1990,3786940,1868053,1918884,84844,42903,41941
768,"Togo",1995,4274024,2113928,2160101,101583,50727,50856
768,"Togo",2000,4970367,2464924,2505440,137891,69081,68810
768,"Togo",2005,5683268,2823622,2859647,203379,102877,100502
768,"Togo",2010,6502952,3237086,3265860,255262,129280,125982
768,"Togo",2015,7416802,3695718,3721088,276844,139298,137546
768,"Togo",2017,7797694,3887057,3910639,283966,142882,141084
678,"Sao Tome and Principe",1990,113893,56396,57492,5582,2953,2629
678,"Sao Tome and Principe",1995,126454,62712,63747,4936,2548,2388
678,"Sao Tome and Principe",2000,138606,68812,69794,4365,2212,2153
678,"Sao Tome and Principe",2005,155630,77356,78271,3433,1727,1706
678,"Sao Tome and Principe",2010,174776,86964,87806,2700,1352,1348
678,"Sao Tome and Principe",2015,195553,97361,98188,2394,1197,1197
678,"Sao Tome and Principe",2017,204327,101755,102580,2293,1147,1146
788,"Tunisia",1990,8232797,4139447,4093350,37984,18900,19084
788,"Tunisia",1995,9113975,4589801,4524172,37867,19045,18822
788,"Tunisia",2000,9699197,4865994,4833191,36446,18523,17923
788,"Tunisia",2005,10102482,5031531,5070945,35040,18000,17040
788,"Tunisia",2010,10639931,5276099,5363833,43172,22236,20936
788,"Tunisia",2015,11273661,5570360,5703301,56701,29351,27350
788,"Tunisia",2017,11532127,5697119,5835007,57663,29849,27814
792,"Turkey",1990,53921699,26630238,27291452,1163686,577329,586357
792,"Turkey",1995,58486381,28836406,29649969,1216173,593938,622235
792,"Turkey",2000,63240121,31144014,32096110,1280963,616007,664956
792,"Turkey",2005,67903406,33419568,34483840,1319236,618938,700298
792,"Turkey",2010,72326914,35564195,36762714,1367034,625960,741074
792,"Turkey",2015,78271472,38503090,39768385,4131302,1939780,2191522
792,"Turkey",2017,80745020,39767136,40977887,4881966,2292242,2589724
798,"Tuvalu",1990,9003,NA,NA,318,180,138
798,"Tuvalu",1995,9230,NA,NA,263,148,115
798,"Tuvalu",2000,9420,NA,NA,217,121,96
798,"Tuvalu",2005,10027,NA,NA,183,101,82
798,"Tuvalu",2010,10531,NA,NA,154,85,69
798,"Tuvalu",2015,11001,NA,NA,141,78,63
798,"Tuvalu",2017,11192,NA,NA,143,79,64
795,"Turkmenistan",1990,3683966,1810473,1873504,306500,134174,172326
795,"Turkmenistan",1995,4207840,2071646,2136194,273565,118851,154714
795,"Turkmenistan",2000,4516131,2222831,2293294,218498,94168,124330
795,"Turkmenistan",2005,4754641,2338887,2415761,213051,94406,118645
795,"Turkmenistan",2010,5087210,2502513,2584695,197979,90600,107379
795,"Turkmenistan",2015,5565284,2740069,2825210,196386,91523,104863
795,"Turkmenistan",2017,5758075,2835285,2922786,195061,90906,104155
834,"United Republic of Tanzania",1990,25459604,12593975,12865637,574025,283390,290635
834,"United Republic of Tanzania",1995,29960776,14818278,15142497,1106043,547089,558954
834,"United Republic of Tanzania",2000,34178042,16914319,17263715,928180,470962,457218
834,"United Republic of Tanzania",2005,39410545,19440653,19969893,770846,486774,284072
834,"United Republic of Tanzania",2010,46098591,22749591,23349004,308600,153984,154616
834,"United Republic of Tanzania",2015,53879957,26626877,27253074,413309,206327,206982
834,"United Republic of Tanzania",2017,57310019,28341969,28968047,492574,245897,246677
800,"Uganda",1990,17438907,8657463,8781443,558307,290084,268223
800,"Uganda",1995,20550291,10169954,10380329,634620,321360,313260
800,"Uganda",2000,24039274,11884262,12155006,634703,314325,320378
800,"Uganda",2005,28543940,14133031,14410903,652968,322421,330547
800,"Uganda",2010,33915133,16840539,17074599,529160,261646,267514
800,"Uganda",2015,40144870,19962086,20182781,1197162,565433,631729
800,"Uganda",2017,42862958,21320841,21542114,1692120,793851,898269
826,"United Kingdom",1990,57183331,27790846,29392490,3650286,1756448,1893838
826,"United Kingdom",1995,57978321,28185041,29793278,4155293,1978711,2176582
826,"United Kingdom",2000,58950848,28722317,30228530,4730165,2228628,2501537
826,"United Kingdom",2005,60286754,29514523,30772228,5926156,2818177,3107979
826,"United Kingdom",2010,63306843,31099747,32207098,7604583,3667186,3937397
826,"United Kingdom",2015,65397080,32231542,33165548,8411021,4023652,4387369
826,"United Kingdom",2017,66181585,32654811,33526775,8841717,4205418,4636299
804,"Ukraine",1990,51464348,23933312,27531029,6892920,2953603,3939317
804,"Ukraine",1995,50905677,23732299,27173381,6172338,2644845,3527493
804,"Ukraine",2000,48840074,22734167,26105923,5527087,2368364,3158723
804,"Ukraine",2005,46892163,21750312,25141857,5050302,2168060,2882242
804,"Ukraine",2010,45792501,21136606,24655899,4818767,2072474,2746293
804,"Ukraine",2015,44657704,20636968,24020746,4915142,2113924,2801218
804,"Ukraine",2017,44222947,20445567,23777389,4964293,2135064,2829229
840,"United States",1990,252529950,123733184,128796765,23251026,11372985,11878041
840,"United States",1995,265658849,130508580,135150271,28451053,14032159,14418894
840,"United States",2000,281982778,138883472,143099301,34814053,17310785,17503268
840,"United States",2005,295129501,145631973,149497532,39258293,19614878,19643415
840,"United States",2010,308641391,152447660,156193735,44183643,21694169,22489474
840,"United States",2015,319929162,158268854,161660310,48178877,23414935,24763942
840,"United States",2017,324459463,160593072,163866396,49776970,24191609,25585361
854,"Burkina Faso",1990,8811034,4305690,4505343,349657,167836,181821
854,"Burkina Faso",1995,10089878,4942641,5147239,434848,209117,225731
854,"Burkina Faso",2000,11607942,5701662,5906289,520039,250399,269640
854,"Burkina Faso",2005,13421930,6622003,6799932,596972,285542,311430
854,"Burkina Faso",2010,15605217,7737619,7867592,673904,320684,353220
854,"Burkina Faso",2015,18110624,9018772,9091844,704676,335328,369348
854,"Burkina Faso",2017,19193382,9571934,9621447,708921,337349,371572
858,"Uruguay",1990,3109989,1508497,1601492,98116,45830,52286
858,"Uruguay",1995,3224804,1562191,1662613,93428,43427,50001
858,"Uruguay",2000,3321245,1607436,1713808,88871,41093,47778
858,"Uruguay",2005,3325612,1605187,1720425,82318,37658,44660
858,"Uruguay",2010,3374415,1627196,1747221,76263,34507,41756
858,"Uruguay",2015,3431552,1656400,1775155,78799,35642,43157
858,"Uruguay",2017,3456750,1669885,1786858,79586,35998,43588
860,"Uzbekistan",1990,20462463,10123258,10339206,1653000,723618,929382
860,"Uzbekistan",1995,22863264,11369461,11493811,1512577,657490,855087
860,"Uzbekistan",2000,24848920,12356996,12491925,1405250,605625,799625
860,"Uzbekistan",2005,26512184,13173199,13338995,1329345,589437,739908
860,"Uzbekistan",2010,28606294,14228018,14378270,1220149,558379,661770
860,"Uzbekistan",2015,30976021,15433638,15542379,1170899,545734,625165
860,"Uzbekistan",2017,31910641,15907189,16003452,1159190,540277,618913
670,"Saint Vincent and the Grenadines",1990,107505,53446,54064,3970,1928,2042
670,"Saint Vincent and the Grenadines",1995,108122,54136,53983,4135,2011,2124
670,"Saint Vincent and the Grenadines",2000,107898,54332,53568,4307,2099,2208
670,"Saint Vincent and the Grenadines",2005,108744,54916,53835,4395,2144,2251
670,"Saint Vincent and the Grenadines",2010,109315,55198,54112,4485,2190,2295
670,"Saint Vincent and the Grenadines",2015,109455,55226,54234,4577,2237,2340
670,"Saint Vincent and the Grenadines",2017,109897,55413,54477,4595,2246,2349
862,"Venezuela",1990,19861956,10007671,9854286,1025009,517579,507430
862,"Venezuela",1995,22188667,11165454,11023213,1019996,513473,506523
862,"Venezuela",2000,24488340,12294127,12194220,1013663,508639,505024
862,"Venezuela",2005,26784161,13406970,13377195,1070562,535096,535466
862,"Venezuela",2010,29028033,14490428,14537620,1331488,667963,663525
862,"Venezuela",2015,31155134,15511223,15643911,1404448,703458,700990
862,"Venezuela",2017,31977065,15905034,16072033,1426336,714422,711914
92,"British Virgin Islands",1990,16461,NA,NA,8035,4126,3909
92,"British Virgin Islands",1995,18427,NA,NA,10046,5034,5012
92,"British Virgin Islands",2000,20645,NA,NA,12958,6386,6572
92,"British Virgin Islands",2005,23168,NA,NA,15016,7401,7615
92,"British Virgin Islands",2010,27224,NA,NA,17074,8415,8659
92,"British Virgin Islands",2015,30113,NA,NA,19132,9430,9702
92,"British Virgin Islands",2017,31196,NA,NA,19959,9838,10121
704,"Viet Nam",1990,68209605,33583931,34625680,28118,15230,12888
704,"Viet Nam",1995,75198977,37054254,38144724,51262,28187,23075
704,"Viet Nam",2000,80285562,39551406,40734159,56754,32825,23929
704,"Viet Nam",2005,84308843,41521818,42787019,51768,31106,20662
704,"Viet Nam",2010,88472512,43683064,44789442,61756,35971,25785
704,"Viet Nam",2015,93571567,46284563,47287006,72793,42168,30625
704,"Viet Nam",2017,95540800,47278445,48262358,76104,44087,32017
850,"United States Virgin Islands",1990,103756,50661,53094,51970,24824,27146
850,"United States Virgin Islands",1995,107392,52013,55375,54241,25760,28481
850,"United States Virgin Islands",2000,108722,52501,56229,56611,26730,29881
850,"United States Virgin Islands",2005,107793,52086,55714,56647,26726,29921
850,"United States Virgin Islands",2010,106149,50800,55348,56684,26722,29962
850,"United States Virgin Islands",2015,104977,50075,54900,56721,26728,29993
850,"United States Virgin Islands",2017,104901,49998,54894,56745,26740,30005
516,"Namibia",1990,1414692,688668,726029,120641,63748,56893
516,"Namibia",1995,1655359,807817,847544,115372,61310,54062
516,"Namibia",2000,1899257,928512,970748,134403,72509,61894
516,"Namibia",2005,2032196,987548,1044651,106274,57034,49240
516,"Namibia",2010,2173170,1052446,1120726,102405,55054,47351
516,"Namibia",2015,2425561,1178734,1246821,96888,52187,44701
516,"Namibia",2017,2533794,1232670,1301123,95067,51207,43860
876,"Wallis and Futuna Islands",1990,13878,NA,NA,1402,726,676
876,"Wallis and Futuna Islands",1995,14142,NA,NA,1680,859,821
876,"Wallis and Futuna Islands",2000,14500,NA,NA,2015,1018,997
876,"Wallis and Futuna Islands",2005,14568,NA,NA,2365,1194,1171
876,"Wallis and Futuna Islands",2010,13428,NA,NA,2776,1401,1375
876,"Wallis and Futuna Islands",2015,12066,NA,NA,2849,1438,1411
876,"Wallis and Futuna Islands",2017,11773,NA,NA,2779,1403,1376
882,"Samoa",1990,162866,85005,77851,3357,1771,1586
882,"Samoa",1995,170157,88480,81666,4694,2451,2243
882,"Samoa",2000,174610,90932,83685,5998,3101,2897
882,"Samoa",2005,179929,93189,86735,5746,2940,2806
882,"Samoa",2010,186205,96051,90154,5122,2594,2528
882,"Samoa",2015,193759,99946,93802,4929,2469,2460
882,"Samoa",2017,196440,101356,95083,4879,2444,2435
748,"Swaziland",1990,861373,405762,455614,72085,38992,33093
748,"Swaziland",1995,960792,460663,500137,25031,14457,10574
748,"Swaziland",2000,1061468,510820,550652,22855,13047,9808
748,"Swaziland",2005,1105873,535160,570714,27097,14721,12376
748,"Swaziland",2010,1202843,583309,619534,30476,15856,14620
748,"Swaziland",2015,1319011,639130,679884,31993,16563,15430
748,"Swaziland",2017,1367254,662136,705118,33263,17221,16042
887,"Yemen",1990,12057039,5972489,6084553,118863,67010,51853
887,"Yemen",1995,15320653,7762540,7558121,136515,77832,58683
887,"Yemen",2000,17874725,9040678,8834050,143495,79675,63820
887,"Yemen",2005,20582927,10400053,10182878,171073,98379,72694
887,"Yemen",2010,23606779,11928388,11678403,285837,154710,131127
887,"Yemen",2015,26916207,13600527,13315676,379899,199399,180500
887,"Yemen",2017,28250420,14271429,13978993,384321,201720,182601
894,"Zambia",1990,8027253,3978480,4048764,279029,142807,136222
894,"Zambia",1995,9137077,4520928,4616158,244338,125329,119009
894,"Zambia",2000,10531221,5208135,5323082,321167,163620,157547
894,"Zambia",2005,12052156,5966889,6085268,252749,128553,124196
894,"Zambia",2010,13850033,6864296,6985740,149637,75775,73862
894,"Zambia",2015,16100587,7988340,8112239,155428,78545,76883
894,"Zambia",2017,17094130,8482225,8611903,156982,79331,77651
716,"Zimbabwe",1990,10183113,5053906,5129208,626821,352028,274793
716,"Zimbabwe",1995,11320346,5588183,5732171,431226,246012,185214
716,"Zimbabwe",2000,12222251,6006798,6215453,410041,233843,176198
716,"Zimbabwe",2005,12940032,6314587,6625447,392693,223970,168723
716,"Zimbabwe",2010,14086317,6859210,7227116,397891,226967,170924
716,"Zimbabwe",2015,15777451,7678096,8099353,403866,227379,176487
716,"Zimbabwe",2017,16529904,8051039,8478859,403866,229881,173985
360,"Indonesia",1990,181436821,91116023,90320803,465612,229885,235727
360,"Indonesia",1995,196957849,98525619,98432228,378960,191600,187360
360,"Indonesia",2000,211540429,105868348,105672083,292307,153315,138992
360,"Indonesia",2005,226712730,113821016,112891718,289568,165493,124075
360,"Indonesia",2010,242524123,122278344,120245778,305416,174864,130552
360,"Indonesia",2015,258162113,130038965,128123149,338124,196717,141407
360,"Indonesia",2017,263991379,132898395,131092981,345930,201259,144671
312,"Guadeloupe",1990,385878,189422,196455,65944,32718,33226
312,"Guadeloupe",1995,402937,196075,206869,74566,36248,38318
312,"Guadeloupe",2000,424646,204526,220123,83188,39778,43410
312,"Guadeloupe",2005,439552,213177,226379,89065,41273,47792
312,"Guadeloupe",2010,450718,210242,240469,94942,42768,52174
312,"Guadeloupe",2015,450418,209035,241376,98507,43858,54649
312,"Guadeloupe",2017,449568,208375,241198,99350,44234,55116
530,"Netherlands Antilles",NA,NA,NA,NA,NA,NA,NA
784,"United Arab Emirates",1990,1860174,1220564,639612,1306574,932046,374528
784,"United Arab Emirates",1995,2448820,1626756,822066,1824118,1309952,514166
784,"United Arab Emirates",2000,3154925,2129351,1025572,2446675,1757144,689531
784,"United Arab Emirates",2005,4579562,3217410,1362164,3281036,2388278,892758
784,"United Arab Emirates",2010,8270684,6161489,2109193,7316611,5463515,1853096
784,"United Arab Emirates",2015,9154302,6694723,2459583,7995126,5970310,2024816
784,"United Arab Emirates",2017,9400145,6806048,2594102,8312524,6207324,2105200
626,"Timor-Leste",1990,751933,380486,371445,8954,4450,4504
626,"Timor-Leste",1995,871447,440470,430977,9743,4763,4980
626,"Timor-Leste",2000,871607,442013,429593,10602,5095,5507
626,"Timor-Leste",2005,1026484,520409,506074,11286,5582,5704
626,"Timor-Leste",2010,1109591,563431,546157,11535,5832,5703
626,"Timor-Leste",2015,1240977,630206,610778,11784,5958,5826
626,"Timor-Leste",2017,1296311,658287,638018,12063,6100,5963
612,"Pitcairn Islands",NA,NA,NA,NA,NA,NA,NA
585,"Palau",1990,15088,NA,NA,2801,1800,1001
585,"Palau",1995,17253,NA,NA,4749,2808,1941
585,"Palau",2000,19175,NA,NA,6310,3905,2405
585,"Palau",2005,19906,NA,NA,6043,3620,2423
585,"Palau",2010,20470,NA,NA,5490,3211,2279
585,"Palau",2015,21288,NA,NA,4937,2802,2135
585,"Palau",2017,21729,NA,NA,4988,2831,2157
584,"Marshall Islands",1990,47298,NA,NA,1158,721,437
584,"Marshall Islands",1995,51015,NA,NA,1480,916,564
584,"Marshall Islands",2000,52159,NA,NA,1891,1164,727
584,"Marshall Islands",2005,52055,NA,NA,2417,1485,932
584,"Marshall Islands",2010,52425,NA,NA,3089,1895,1194
584,"Marshall Islands",2015,52994,NA,NA,3284,2011,1273
584,"Marshall Islands",2017,53127,NA,NA,3292,2016,1276
666,"Saint Pierre and Miquelon",1990,6276,NA,NA,1099,560,539
666,"Saint Pierre and Miquelon",1995,6304,NA,NA,1320,682,638
666,"Saint Pierre and Miquelon",2000,6272,NA,NA,1458,756,702
666,"Saint Pierre and Miquelon",2005,6261,NA,NA,1147,597,550
666,"Saint Pierre and Miquelon",2010,6274,NA,NA,1017,531,486
666,"Saint Pierre and Miquelon",2015,6290,NA,NA,986,516,470
666,"Saint Pierre and Miquelon",2017,6320,NA,NA,990,519,471
654,"Saint Helena",1990,5535,NA,NA,383,222,161
654,"Saint Helena",1995,5289,NA,NA,394,218,176
654,"Saint Helena",2000,5114,NA,NA,405,215,190
654,"Saint Helena",2005,4275,NA,NA,487,263,224
654,"Saint Helena",2010,4177,NA,NA,569,312,257
654,"Saint Helena",2015,4034,NA,NA,604,335,269
654,"Saint Helena",2017,4049,NA,NA,606,337,269
674,"San Marino",1990,24043,NA,NA,3310,1728,1582
674,"San Marino",1995,25877,NA,NA,3659,1940,1719
674,"San Marino",2000,27418,NA,NA,4045,2175,1870
674,"San Marino",2005,29240,NA,NA,4218,2302,1916
674,"San Marino",2010,31110,NA,NA,4399,2435,1964
674,"San Marino",2015,32960,NA,NA,5174,2864,2310
674,"San Marino",2017,33400,NA,NA,5243,2903,2340
796,"Turks and Caicos Islands",1990,11552,NA,NA,5062,2620,2442
796,"Turks and Caicos Islands",1995,15332,NA,NA,7039,3643,3396
796,"Turks and Caicos Islands",2000,18873,NA,NA,9015,4665,4350
796,"Turks and Caicos Islands",2005,26448,NA,NA,13115,6787,6328
796,"Turks and Caicos Islands",2010,30994,NA,NA,17216,8907,8309
796,"Turks and Caicos Islands",2015,34339,NA,NA,22719,11755,10964
796,"Turks and Caicos Islands",2017,35446,NA,NA,24534,12695,11839
732,"Western Sahara",1990,217258,113860,103398,2688,1465,1223
732,"Western Sahara",1995,255634,132884,122751,2989,1651,1338
732,"Western Sahara",2000,314118,164434,149682,3289,1837,1452
732,"Western Sahara",2005,437515,230672,206844,3891,2224,1667
732,"Western Sahara",2010,480274,252879,227389,4493,2612,1881
732,"Western Sahara",2015,526216,276266,249945,5179,3059,2120
732,"Western Sahara",2017,552628,289655,262977,5384,3181,2203
688,"Serbia",1990,9517674,4698052,4819624,99269,46712,52557
688,"Serbia",1995,9884147,4870553,5013590,630221,289545,340676
688,"Serbia",2000,9487615,4656013,4831598,856763,383893,472870
688,"Serbia",2005,9214986,4504932,4710049,845120,373473,471647
688,"Serbia",2010,9029716,4416196,4613525,826066,364654,461412
688,"Serbia",2015,8851280,4325786,4525486,807441,355180,452261
688,"Serbia",2017,8790574,4295430,4495141,801903,352744,449159
336,"Holy See (Vatican City)",1990,768,NA,NA,768,376,392
336,"Holy See (Vatican City)",1995,780,NA,NA,780,378,402
336,"Holy See (Vatican City)",2000,785,NA,NA,785,379,406
336,"Holy See (Vatican City)",2005,798,NA,NA,798,378,420
336,"Holy See (Vatican City)",2010,794,NA,NA,794,377,417
336,"Holy See (Vatican City)",2015,803,NA,NA,803,374,429
336,"Holy See (Vatican City)",2017,792,NA,NA,792,373,419
744,"Svalbard",NA,NA,NA,NA,NA,NA,NA
663,"Saint Martin",NA,NA,NA,NA,NA,NA,NA
652,"Saint Barthelemy",NA,NA,NA,NA,NA,NA,NA
831,"Guernsey",NA,NA,NA,NA,NA,NA,NA
832,"Jersey",NA,NA,NA,NA,NA,NA,NA
239,"South Georgia South Sandwich Islands",NA,NA,NA,NA,NA,NA,NA
158,"Taiwan",NA,NA,NA,NA,NA,NA,NA
